id,State,Year,NationalRank,FemaleSenateDemocrats,FemaleSenateRepublicans,FemaleSenateIndependents,FemaleSenateOther,FemaleSenateTotal,TotalSenateMembers,FemaleHouseDemocrats,FemaleHouseRepublicans,FemaleHouseIndependents,FemaleHouseOther,FemaleHouseTotal,TotalHouseMembers,TotalFemalesinLegislature,TotalLegislatureMembers,PercentageOfFemalesInLegislature
1,Alabama,2019,45,4,0,0,0,4,35,11,8,0,0,19,105,23,140,16.4
2,Alaska,2019,7,1,0,5,0,6,20,6,11,0,0,17,40,23,60,38.3
3,Arizona,2019,6,7,6,0,0,13,30,14,8,0,0,22,60,35,90,38.9
4,Arkansas,2019,36,3,4,0,0,7,35,9,17,0,0,26,100,33,135,24.4
5,California,2019,18,11,3,0,0,14,40,21,3,0,0,24,80,38,120,31.7
6,Colorado,2019,2,12,1,0,0,13,35,26,7,0,0,33,65,46,100,46
7,Connecticut,2019,17,8,1,0,0,9,36,29,22,0,0,51,151,60,187,32.1
8,Deleware,2019,37,4,1,0,0,5,21,9,1,0,0,10,41,15,62,24.2
9,Florida,2019,24,6,6,0,0,12,40,23,13,0,0,36,120,48,160,30
10,Georgia,2019,23,13,2,0,0,15,56,42,15,0,0,57,180,72,236,30.5
11,Hawaii,2019,20,7,0,0,0,7,25,14,3,0,0,17,51,24,76,31.6
12,Idaho,2019,16,4,5,0,0,9,35,8,17,0,0,25,70,34,105,32.4
13,Illinois,2019,11,17,2,0,0,19,59,37,8,0,0,45,118,64,177,36.2
14,Indiana,2019,33,2,8,0,0,10,50,17,11,0,0,28,100,38,150,25.3
15,Iowa,2019,25,6,5,0,0,11,50,23,10,0,0,33,100,44,150,29.3
16,Kansas,2019,28,6,8,0,0,14,40,17,15,0,0,32,125,46,165,27.9
17,Kentucky,2019,39,2,2,0,0,4,38,18,10,0,0,28,100,33,138,23.2
18,Louisiana,2019,47,3,2,0,0,5,39,8,9,0,0,17,105,22,144,15.3
19,Maine,2019,9,8,4,0,0,12,35,47,11,0,0,58,151,70,186,37.6
20,Maryland,2019,7,12,2,0,0,14,47,51,7,0,0,58,141,72,188,38.3
21,Massachusetts,2019,27,11,0,0,0,11,40,38,7,1,0,46,160,57,200,28.5
22,Michigan,2019,12,8,3,0,0,11,38,25,17,0,0,42,110,53,148,35.8
23,Minnesota,2019,21,10,6,0,0,16,67,34,13,0,0,47,134,63,201,31.3
24,Mississippi,2019,49,4,5,0,0,9,52,8,7,0,0,15,122,24,174,13.8
25,Missouri,2019,38,6,3,0,0,9,34,18,20,0,0,38,163,47,197,23.9
26,Montana,2019,22,11,2,0,0,13,50,22,11,0,0,33,100,46,150,30.7
27,Nebraska*,2019,26,0,0,0,0,14,49,0,0,0,0,0,0,14,49,28.6
28,Nevada,2019,1,9,1,0,0,10,21,18,5,0,0,23,42,33,63,52.4
29,New Hampshire,2019,14,7,3,0,0,10,24,109,25,0,0,134,400,144,424,34
30,New Jersey,2019,18,9,1,0,0,10,40,21,7,0,0,28,80,38,120,31.7
31,New Mexico,2019,13,7,2,0,0,9,42,24,7,0,0,31,70,40,112,35.7
32,New York,2019,15,14,5,0,0,19,63,46,4,0,0,50,150,69,213,32.4
33,North Carolina,2019,33,6,4,0,0,10,50,23,10,0,0,33,120,43,170,25.3
34,North Dakota,2019,42,4,7,0,0,11,47,8,12,0,0,20,94,31,141,22
35,Ohio,2019,29,4,4,0,0,8,33,19,9,0,0,28,99,36,132,27.3
36,Oklahoma,2019,43,5,4,0,0,9,48,11,12,0,0,23,101,32,149,21.5
37,Oregon,2019,3,7,2,0,0,9,30,22,7,0,0,29,60,38,90,42.2
38,Pennsylvania,2019,32,7,6,0,0,13,50,30,23,0,0,53,203,66,253,26.1
39,Rhode Island,2019,10,14,2,0,0,16,38,25,1,0,0,26,75,42,113,37.2
40,South Carolina,2019,44,2,2,0,0,4,46,12,12,0,0,24,124,28,170,16.5
41,South Dakota,2019,41,2,3,0,0,5,35,4,15,0,0,19,70,24,105,22.9
42,Tennessee,2019,48,4,4,0,0,8,33,4,8,0,0,12,99,20,132,15.2
43,Texas,2019,39,3,6,0,0,9,31,27,6,0,0,33,150,42,181,23.2
44,Utah,2019,35,4,2,0,0,6,29,12,8,0,0,20,75,26,104,25
45,Vermont,2019,5,10,0,0,0,10,30,41,14,3,1,62,150,72,180,40
46,Virginia,2019,31,7,3,0,0,10,40,22,5,0,0,27,100,37,140,26.4
47,Washington,2019,4,12,7,0,0,19,49,30,10,0,0,40,98,59,147,40.1
48,West Virginia,2019,50,0,3,0,0,3,34,8,7,0,0,15,100,18,134,13.4
49,Wisconsin,2019,29,6,2,0,0,8,33,18,10,0,0,28,99,36,132,27.3
50,Wyoming,2019,46,1,5,0,0,6,30,4,4,0,0,8,60,14,90,15.6
51,Alabama,2018,45,3,0,1,0,4,35,12,5,0,0,17,105,21,140,15
52,Alaska,2018,12,1,0,5,0,6,20,4,9,0,0,13,40,19,60,31.7
53,Arizona,2018,1,6,8,0,0,14,30,13,9,0,0,22,60,36,90,40
54,Arkansas,2018,40,3,5,0,0,8,35,3,15,0,0,18,100,26,135,19.3
55,California,2018,25,7,4,0,0,11,40,17,3,0,0,20,80,31,120,25.8
56,Colorado,2018,4,8,2,1,0,11,35,18,9,0,0,27,65,38,100,38
57,Connecticut,2018,21,7,2,0,0,9,36,21,21,0,0,42,151,51,187,27.3
58,Deleware,2018,34,3,1,0,0,4,21,7,2,0,0,9,41,13,62,21
59,Florida,2018,26,6,7,0,0,13,40,14,14,0,0,28,120,41,160,25.6
60,Georgia,2018,23,11,2,0,0,13,56,32,18,0,0,50,180,63,236,26.7
61,Hawaii,2018,16,7,0,0,0,7,25,12,3,0,0,15,51,22,76,28.9
62,Idaho,2018,14,4,5,0,0,9,35,7,16,0,0,23,70,32,105,30.5
63,Illinois,2018,6,13,2,0,0,15,59,34,13,0,0,47,118,62,177,35
64,Indiana,2018,36,2,6,0,0,8,50,11,11,0,0,22,100,30,150,20
65,Iowa,2018,31,5,2,0,0,7,50,19,9,0,0,28,100,35,150,22.3
66,Kansas,2018,18,4,11,0,0,15,40,15,17,0,0,32,125,47,165,28.5
67,Kentucky,2018,42,2,2,0,0,4,38,10,9,0,0,19,100,23,138,16.7
68,Louisiana,2018,48,3,2,0,0,5,39,7,9,0,0,16,105,21,144,14.6
69,Maine,2018,7,6,4,0,0,10,35,35,17,1,0,53,151,63,186,33.9
70,Maryland,2018,8,10,3,0,0,13,47,39,11,0,0,50,141,63,188,33.5
71,Massachusetts,2018,29,10,0,0,0,10,40,30,8,1,0,39,160,49,200,24.5
72,Michigan,2018,27,1,3,0,0,4,38,17,16,0,0,33,110,37,148,25
73,Minnesota,2018,11,10,6,0,0,16,67,28,20,0,0,48,134,64,201,31.8
74,Mississippi,2018,46,4,5,0,0,9,52,10,7,0,0,17,122,26,174,14.9
75,Missouri,2018,32,6,2,0,0,8,34,16,21,0,0,37,163,45,197,22.8
76,Montana,2018,20,11,2,0,0,13,50,21,8,0,0,29,100,42,150,28
77,Nebraska*,2018,24,0,0,0,0,13,49,0,0,0,0,0,0,13,49,26.5
78,Nevada,2018,3,5,1,0,1,7,21,13,4,0,0,17,42,24,63,38.1
79,New Hampshire,2018,17,4,3,0,0,7,24,77,38,0,0,115,400,122,424,28.8
80,New Jersey,2018,13,8,2,0,0,10,40,21,6,0,0,27,80,37,120,30.8
81,New Mexico,2018,15,5,2,0,0,7,42,17,10,0,0,27,70,34,112,30.4
82,New York,2018,19,8,7,0,0,15,63,42,3,0,0,45,150,60,213,28.2
83,North Carolina,2018,28,5,8,0,0,13,50,17,12,0,0,29,120,42,170,24.7
84,North Dakota,2018,41,3,6,0,0,9,47,7,10,0,0,17,94,26,141,18.4
85,Ohio,2018,33,3,3,0,0,6,33,13,10,0,0,23,99,29,132,22
86,Oklahoma,2018,48,3,3,0,0,6,48,5,8,0,0,12,101,19,149,12.8
87,Oregon,2018,9,6,2,0,0,8,30,19,3,0,0,22,60,30,90,33.3
88,Pennsylvania,2018,39,3,4,0,0,7,50,21,21,0,0,42,203,49,253,19.4
89,Rhode Island,2018,10,12,1,0,0,13,38,21,2,0,0,23,75,36,113,31.9
90,South Carolina,2018,43,2,2,0,0,4,46,12,11,0,0,23,124,27,170,15.9
91,South Dakota,2018,34,0,5,0,0,5,35,3,14,0,0,17,70,22,105,21
92,Tennessee,2018,43,2,3,0,0,5,33,7,9,0,0,16,99,21,132,15.9
93,Texas,2018,36,2,6,0,0,8,31,21,8,0,0,29,150,37,181,20.4
94,Utah,2018,37,3,2,0,0,5,29,9,7,0,0,16,75,21,104,20.2
95,Vermont,2018,2,9,2,0,0,11,30,39,13,3,5,60,150,71,180,39.4
96,Virginia,2018,22,7,3,0,0,10,40,23,5,0,0,28,100,38,140,27.1
97,Washington,2018,5,10,9,0,0,19,49,25,11,0,0,36,98,55,147,37.4
98,West Virginia,2018,46,0,4,0,0,4,34,2,14,0,0,16,100,20,134,14.9
99,Wisconsin,2018,30,7,2,0,0,9,33,14,9,0,0,23,99,32,132,24.2
100,Wyoming,2018,50,1,2,0,0,3,30,3,4,0,0,7,60,10,90,11.1
101,Alabama,2017,45,3,0,1,0,4,35,12,5,0,0,17,105,21,140,15
102,Alaska,2017,15,1,0,5,0,6,20,3,9,0,0,12,40,18,60,30
103,Arizona,2017,1,6,8,0,0,14,30,13,9,0,0,22,60,36,90,40
104,Arkansas,2017,40,3,4,0,0,7,35,3,15,0,0,18,100,25,135,18.5
105,California,2017,30,6,3,0,0,9,40,15,3,0,0,18,80,27,120,22.5
106,Colorado,2017,4,9,2,0,0,11,35,18,8,0,0,26,65,37,100,37
107,Connecticut,2017,19,7,2,0,0,9,36,21,22,0,0,43,151,52,187,27.8
108,Deleware,2017,33,3,1,0,0,4,21,7,2,0,0,9,41,13,62,21
109,Florida,2017,26,5,8,0,0,13,40,14,13,0,0,27,120,40,160,25
110,Georgia,2017,22,11,2,0,0,13,56,32,19,0,0,51,180,64,236,27.1
111,Hawaii,2017,21,7,0,0,0,7,25,12,3,0,0,15,51,22,76,28.9
112,Idaho,2017,13,4,5,0,0,9,35,7,16,0,0,23,70,32,105,30.5
113,Illinois,2017,6,13,4,0,0,17,59,33,12,0,0,45,118,62,177,35
114,Indiana,2017,36,2,6,0,0,8,50,11,11,0,0,22,100,30,150,20
115,Iowa,2017,28,5,1,0,0,6,50,19,9,0,0,28,100,34,150,22.7
116,Kansas,2017,18,4,11,0,0,15,40,15,17,0,0,32,125,47,165,28.5
117,Kentucky,2017,42,2,2,0,0,4,38,9,10,0,0,19,100,23,138,16.7
118,Louisiana,2017,44,3,2,0,0,5,39,8,9,0,0,17,105,22,144,15.3
119,Maine,2017,7,6,4,0,0,10,35,35,17,1,0,53,151,63,186,33.9
120,Maryland,2017,10,9,2,0,0,11,47,38,11,0,0,49,141,60,188,31.9
121,Massachusetts,2017,24,12,0,0,0,12,40,30,8,1,0,39,160,51,200,25.5
122,Michigan,2017,26,1,3,0,0,4,38,17,16,0,0,33,110,37,148,25
123,Minnesota,2017,9,9,7,0,0,16,67,28,21,0,0,49,134,65,201,32.3
124,Mississippi,2017,46,4,5,0,0,9,52,10,7,0,0,17,122,26,174,14.9
125,Missouri,2017,31,5,2,0,0,7,34,17,20,0,0,37,163,44,197,22.3
126,Montana,2017,17,12,2,0,0,14,50,21,8,0,0,29,100,43,150,28.7
127,Nebraska*,2017,23,0,0,0,0,13,49,0,0,0,0,0,0,13,49,26.5
128,Nevada,2017,3,5,2,0,1,8,21,13,4,0,0,17,42,25,63,39.7
129,New Hampshire,2017,16,4,3,0,0,7,24,80,39,0,0,119,400,126,424,29.7
130,New Jersey,2017,12,8,4,0,0,12,40,18,7,0,0,25,80,37,120,30.8
131,New Mexico,2017,14,5,2,0,0,7,42,17,10,0,0,27,70,34,112,30.4
132,New York,2017,20,7,7,0,0,14,63,41,3,1,0,45,150,59,213,27.7
133,North Carolina,2017,25,6,7,0,0,13,50,17,13,0,0,30,120,43,170,25.3
134,North Dakota,2017,41,3,6,0,0,9,47,7,10,0,0,17,94,26,141,18.4
135,Ohio,2017,32,3,3,0,0,6,33,13,10,0,0,23,99,29,132,22
136,Oklahoma,2017,48,2,4,0,0,6,48,6,8,0,0,14,101,20,149,13.4
137,Oregon,2017,8,6,2,0,0,8,30,19,3,0,0,22,60,30,90,33.3
138,Pennsylvania,2017,39,3,4,0,0,7,50,19,21,0,0,40,203,47,253,18.6
139,Rhode Island,2017,11,11,1,0,0,12,38,21,2,0,0,23,75,35,113,31
140,South Carolina,2017,47,2,2,0,0,4,46,11,9,0,0,20,124,24,170,14.1
141,South Dakota,2017,36,0,5,0,0,5,35,3,13,0,0,16,70,21,105,20
142,Tennessee,2017,43,2,3,0,0,5,33,7,9,0,0,16,99,21,132,15.9
143,Texas,2017,34,2,6,0,0,8,31,21,8,0,0,29,150,37,181,20.4
144,Utah,2017,35,3,3,0,0,6,29,9,6,0,0,15,75,21,104,20.2
145,Vermont,2017,1,9,2,0,0,11,30,40,13,3,5,61,150,72,180,40
146,Virginia,2017,38,7,3,0,0,10,40,13,4,0,0,17,100,27,140,19.3
147,Washington,2017,4,10,9,0,0,19,49,25,11,0,0,36,98,55,147,37.4
148,West Virginia,2017,48,0,3,0,0,3,34,2,13,0,0,15,100,18,134,13.4
149,Wisconsin,2017,30,6,2,0,0,8,33,13,9,0,0,22,99,30,132,22.7
150,Wyoming,2017,50,1,2,0,0,3,30,3,4,0,0,7,60,10,90,11.1
151,Alabama,2016,46,3,0,1,0,4,35,11,5,0,0,16,105,20,140,14.3
152,Alaska,2016,11,1,0,4,0,5,20,3,10,0,0,13,40,18,60,30
153,Arizona,2016,3,6,7,0,0,13,30,11,8,0,0,19,60,32,90,35.6
154,Arkansas,2016,36,3,4,0,0,7,35,6,14,0,0,20,100,27,135,20
155,California,2016,22,8,3,0,0,11,40,11,8,0,0,19,80,30,120,25
156,Colorado,2016,1,8,4,0,0,12,35,20,10,0,0,30,65,42,100,42
157,Connecticut,2016,16,8,1,0,0,9,36,24,19,0,0,43,151,52,187,27.8
158,Deleware,2016,28,5,1,0,0,6,21,7,2,0,0,9,41,15,62,24.2
159,Florida,2016,22,6,6,0,0,12,40,13,15,0,0,28,120,40,160,25
160,Georgia,2016,27,8,2,0,0,10,56,29,19,0,0,48,180,58,236,24.6
161,Hawaii,2016,14,8,0,0,0,8,25,10,4,0,0,14,51,22,76,28.9
162,Idaho,2016,17,4,6,0,0,10,35,7,12,0,0,19,70,29,105,27.6
163,Illinois,2016,6,12,4,0,0,16,59,32,10,0,0,42,118,58,177,32.8
164,Indiana,2016,34,3,6,0,0,9,50,12,10,0,0,22,100,31,150,20.7
165,Iowa,2016,31,6,1,0,0,7,50,21,6,0,0,27,100,34,150,22.7
166,Kansas,2016,29,4,9,0,0,13,40,9,17,0,0,26,125,39,165,23.6
167,Kentucky,2016,42,2,2,0,0,4,38,10,8,0,0,18,100,22,138,15.9
168,Louisiana,2016,44,3,2,0,0,5,39,8,9,0,0,17,105,22,144,15.3
169,Maine,2016,13,6,3,0,0,9,35,30,16,0,0,46,151,55,186,29.6
170,Maryland,2016,7,10,2,0,0,12,47,37,11,0,0,48,141,60,188,31.9
171,Massachusetts,2016,22,12,0,0,0,12,40,29,9,0,0,38,160,50,200,25
172,Michigan,2016,35,1,3,0,0,4,38,16,10,0,0,26,110,30,148,20.3
173,Minnesota,2016,5,15,8,0,0,23,67,26,18,0,0,44,134,67,201,33.3
174,Mississippi,2016,50,4,5,0,0,9,52,9,5,0,0,14,122,23,174,13.2
175,Missouri,2016,26,5,1,0,0,6,34,19,24,0,0,43,163,49,197,24.9
176,Montana,2016,9,12,6,0,0,18,50,21,8,0,0,29,100,47,150,31.3
177,Nebraska*,2016,32,0,0,0,0,11,49,0,0,0,0,0,0,11,49,22.4
178,Nevada,2016,8,2,2,0,0,4,21,9,7,0,0,16,42,20,63,31.7
179,New Hampshire,2016,15,4,4,0,0,8,24,67,45,0,0,112,400,120,424,28.3
180,New Jersey,2016,11,8,3,0,0,11,40,18,7,0,0,25,80,36,120,30
181,New Mexico,2016,19,4,2,0,0,6,42,13,10,0,0,23,70,29,112,25.9
182,New York,2016,20,6,5,0,0,11,63,38,5,1,0,44,150,55,213,25.8
183,North Carolina,2016,30,7,6,0,0,13,50,14,12,0,0,26,120,39,170,22.9
184,North Dakota,2016,39,4,4,0,0,8,47,11,8,0,0,19,94,27,141,19.1
185,Ohio,2016,22,4,3,0,0,7,33,14,12,0,0,26,99,33,132,25
186,Oklahoma,2016,47,3,3,0,0,6,48,5,10,0,0,15,101,21,149,14.1
187,Oregon,2016,10,6,2,0,0,8,30,16,4,0,0,20,60,28,90,31.1
188,Pennsylvania,2016,40,4,5,0,0,9,50,15,23,0,0,38,203,47,253,18.6
189,Rhode Island,2016,18,9,1,0,0,10,38,18,3,0,0,21,75,31,113,27.4
190,South Carolina,2016,47,1,1,0,0,2,46,12,10,0,0,22,124,24,170,14.1
191,South Dakota,2016,33,1,6,0,0,7,35,4,11,0,0,15,70,22,105,21
192,Tennessee,2016,41,2,4,0,0,6,33,7,9,0,0,16,99,22,132,16.7
193,Texas,2016,37,2,5,0,0,7,31,16,13,0,0,29,150,36,181,19.9
194,Utah,2016,43,3,3,0,0,6,29,7,3,0,0,10,75,16,104,15.4
195,Vermont,2016,2,7,2,0,0,9,30,44,15,3,3,65,150,74,180,41.1
196,Virginia,2016,38,7,2,0,0,9,40,14,4,0,0,18,100,27,140,19.3
197,Washington,2016,4,9,8,0,0,17,49,20,13,0,0,33,98,50,147,34
198,West Virginia,2016,44,0,2,0,0,2,34,6,12,0,0,18,100,20,134,14.9
199,Wisconsin,2016,20,7,4,0,0,11,33,14,9,0,0,23,99,34,132,25.8
200,Wyoming,2016,49,1,0,0,0,1,30,3,8,0,0,11,60,12,90,13.3
201,Alabama,2015,46,3,0,1,0,4,35,11,5,0,0,16,105,20,140,14.3
202,Alaska,2015,15,1,0,4,0,5,20,2,10,0,0,12,40,17,60,28.3
203,Arizona,2015,3,6,7,0,0,13,30,11,8,0,0,19,60,32,90,35.6
204,Arkansas,2015,36,3,4,0,0,7,35,6,14,0,0,20,100,27,135,20
205,California,2015,20,8,4,0,0,12,40,11,8,0,0,19,80,31,120,25.8
206,Colorado,2015,1,8,4,0,0,12,35,20,10,0,0,30,65,42,100,42
207,Connecticut,2015,15,8,1,0,0,9,36,25,19,0,0,44,151,53,187,28.3
208,Deleware,2015,28,5,1,0,0,6,21,7,2,0,0,9,41,15,62,24.2
209,Florida,2015,23,6,6,0,0,12,40,13,15,0,0,28,120,40,160,25
210,Georgia,2015,29,8,2,0,0,10,56,28,18,0,0,46,180,56,236,23.7
211,Hawaii,2015,13,8,0,0,0,8,25,10,4,0,0,14,51,22,76,28.9
212,Idaho,2015,17,4,6,0,0,10,35,7,12,0,0,19,70,29,105,27.6
213,Illinois,2015,7,12,4,0,0,16,59,32,10,0,0,42,118,58,177,32.8
214,Indiana,2015,34,3,6,0,0,9,50,12,10,0,0,22,100,31,150,20.7
215,Iowa,2015,29,6,1,0,0,7,50,21,6,0,0,27,100,34,150,22.7
216,Kansas,2015,27,4,9,0,0,13,40,11,17,0,0,28,125,41,165,24.8
217,Kentucky,2015,43,2,2,0,0,4,38,11,8,0,0,19,100,23,138,16.7
218,Louisiana,2015,50,3,1,0,0,4,39,9,5,0,0,14,105,18,144,12.5
219,Maine,2015,12,5,3,0,0,8,35,30,16,0,0,46,151,54,186,29
220,Maryland,2015,8,11,2,0,0,13,47,36,11,0,0,47,141,60,188,31.9
221,Massachusetts,2015,23,12,0,0,0,12,40,29,9,0,0,38,160,50,200,25
222,Michigan,2015,35,1,3,0,0,4,38,17,9,0,0,26,110,30,148,20.3
223,Minnesota,2015,5,15,8,0,0,23,67,27,18,0,0,45,134,68,201,33.8
224,Mississippi,2015,41,2,6,0,0,8,52,16,6,0,0,22,122,30,174,17.2
225,Missouri,2015,26,5,1,0,0,6,34,19,24,0,0,43,163,49,197,24.9
226,Montana,2015,9,12,6,0,0,18,50,21,8,0,0,29,100,47,150,31.3
227,Nebraska*,2015,31,0,0,0,0,11,49,0,0,0,0,0,0,11,49,22.4
228,Nevada,2015,6,3,2,0,0,5,21,9,7,0,0,16,42,21,63,33.3
229,New Hampshire,2015,14,4,4,0,0,8,24,69,45,0,0,114,400,122,424,28.8
230,New Jersey,2015,11,8,3,0,0,11,40,16,10,0,0,26,80,37,120,30.8
231,New Mexico,2015,19,4,3,0,0,7,42,13,10,0,0,23,70,30,112,26.8
232,New York,2015,20,7,5,0,0,12,63,37,5,1,0,43,150,55,213,25.8
233,North Carolina,2015,31,7,5,0,0,12,50,14,12,0,0,26,120,38,170,22.4
234,North Dakota,2015,38,4,4,0,0,8,47,11,8,0,0,19,94,27,141,19.1
235,Ohio,2015,23,4,3,0,0,7,33,13,13,0,0,26,99,33,132,25
236,Oklahoma,2015,47,3,3,0,0,6,48,5,10,0,0,15,101,21,149,14.1
237,Oregon,2015,10,6,2,0,0,8,30,16,4,0,0,20,60,28,90,31.1
238,Pennsylvania,2015,39,4,5,0,0,9,50,16,23,0,0,39,203,48,253,19
239,Rhode Island,2015,18,9,1,0,0,10,38,18,3,0,0,21,75,31,113,27.4
240,South Carolina,2015,47,1,1,0,0,2,46,12,10,0,0,22,124,24,170,14.1
241,South Dakota,2015,33,1,6,0,0,7,35,4,11,0,0,15,70,22,105,21
242,Tennessee,2015,40,2,4,0,0,6,33,7,10,0,0,17,99,23,132,17.4
243,Texas,2015,37,2,5,0,0,7,31,16,13,0,0,29,150,36,181,19.9
244,Utah,2015,44,3,3,0,0,6,29,7,3,0,0,10,75,16,104,15.4
245,Vermont,2015,2,7,2,0,0,9,30,47,15,3,0,65,150,74,180,41.1
246,Virginia,2015,42,7,1,0,0,8,40,12,4,0,0,16,100,24,140,17.1
247,Washington,2015,4,10,8,0,0,18,49,19,13,0,0,32,98,50,147,34
248,West Virginia,2015,45,0,1,0,0,1,34,6,13,0,0,19,100,20,134,14.9
249,Wisconsin,2015,20,7,4,0,0,11,33,14,9,0,0,23,99,34,132,25.8
250,Wyoming,2015,49,1,0,0,0,1,30,3,8,0,0,11,60,12,90,13.3
251,Alabama,2014,47,4,0,1,0,5,35,9,6,0,0,15,105,20,140,14.3
252,Alaska,2014,17,1,0,3,0,4,20,2,10,0,0,12,40,16,60,26.7
253,Arizona,2014,3,7,6,0,0,13,30,11,8,0,0,19,60,32,90,35.6
254,Arkansas,2014,42,3,3,0,0,6,35,7,10,0,0,17,100,23,135,17
255,California,2014,17,10,2,0,0,12,40,13,7,0,0,20,80,32,120,26.7
256,Colorado,2014,1,11,2,0,0,13,35,18,10,0,0,28,65,41,100,41
257,Connecticut,2014,13,7,1,0,0,8,36,29,18,0,0,47,151,55,187,29.4
258,Deleware,2014,21,5,1,0,0,6,21,8,2,0,0,10,41,16,62,25.8
259,Florida,2014,23,6,6,0,0,12,40,16,13,0,0,29,120,41,160,25.6
260,Georgia,2014,28,7,1,0,0,8,56,29,16,0,0,45,180,53,236,22.5
261,Hawaii,2014,10,8,0,0,0,8,25,12,3,0,0,15,51,23,76,30.3
262,Idaho,2014,17,3,3,0,0,6,35,8,14,0,0,22,70,28,105,26.7
263,Illinois,2014,7,11,4,0,0,15,59,32,10,0,0,42,118,57,177,32.2
264,Indiana,2014,33,3,5,0,0,8,50,13,10,0,0,23,100,31,150,20.7
265,Iowa,2014,27,6,4,0,0,10,50,19,6,0,0,25,100,35,150,23.3
266,Kansas,2014,24,4,9,0,0,13,40,16,13,0,0,29,125,42,165,25.5
267,Kentucky,2014,37,2,4,0,0,6,38,10,9,0,0,19,100,25,138,18.1
268,Louisiana,2014,50,3,1,0,0,4,39,10,4,0,0,14,105,18,144,12.5
269,Maine,2014,12,8,0,0,0,8,35,34,13,0,0,47,151,55,186,29.6
270,Maryland,2014,10,10,1,0,0,11,47,34,12,0,0,46,141,57,188,30.3
271,Massachusetts,2014,25,12,0,0,0,12,40,31,7,0,0,38,160,50,200,25
272,Michigan,2014,36,2,2,0,0,4,38,16,8,0,0,24,110,28,148,18.9
273,Minnesota,2014,4,15,8,0,0,23,67,28,17,0,0,45,134,68,201,33.8
274,Mississippi,2014,40,2,6,0,0,8,52,16,6,0,0,22,122,30,174,17.2
275,Missouri,2014,29,5,0,0,0,5,34,19,20,0,0,39,163,44,197,22.3
276,Montana,2014,15,6,5,0,0,11,50,22,8,0,0,30,100,41,150,27.3
277,Nebraska*,2014,35,0,0,0,0,10,49,0,0,0,0,0,0,10,49,20.4
278,Nevada,2014,16,3,1,0,0,4,21,11,2,0,0,13,42,17,63,27
279,New Hampshire,2014,5,6,3,0,0,9,24,98,32,0,0,130,400,139,424,32.8
280,New Jersey,2014,9,8,3,0,0,11,40,16,10,0,0,26,80,37,120,30.8
281,New Mexico,2014,14,3,3,0,0,6,42,15,11,0,0,26,70,32,112,28.6
282,New York,2014,33,7,4,0,0,11,63,29,4,0,0,33,150,44,213,20.7
283,North Carolina,2014,31,5,5,0,0,10,50,14,13,0,0,27,120,37,170,21.8
284,North Dakota,2014,39,3,5,0,0,8,47,7,10,0,0,17,94,25,141,17.7
285,Ohio,2014,26,5,3,0,0,8,33,11,12,0,0,23,99,31,132,23.5
286,Oklahoma,2014,48,2,2,0,0,4,48,5,11,0,0,16,101,20,149,13.4
287,Oregon,2014,8,5,2,0,0,7,30,15,6,0,0,21,60,28,90,31.1
288,Pennsylvania,2014,38,4,4,0,0,8,50,16,21,0,0,37,203,45,253,17.8
289,Rhode Island,2014,20,9,0,0,0,9,38,19,2,0,0,21,75,30,113,26.5
290,South Carolina,2014,49,0,1,0,0,1,46,11,10,0,0,21,124,22,170,12.9
291,South Dakota,2014,30,1,5,0,0,6,35,6,11,0,0,17,70,23,105,21.9
292,Tennessee,2014,43,3,4,0,0,7,33,7,8,0,0,15,99,22,132,16.7
293,Texas,2014,32,4,3,0,0,7,31,17,15,0,0,32,150,39,181,21.5
294,Utah,2014,45,3,2,0,0,5,29,8,4,0,0,12,75,17,104,16.3
295,Vermont,2014,2,6,2,0,0,8,30,51,12,0,0,63,150,71,180,39.4
296,Virginia,2014,41,6,1,0,0,7,40,12,5,0,0,17,100,24,140,17.1
297,Washington,2014,6,10,8,0,0,18,49,21,9,0,0,30,98,48,147,32.7
298,West Virginia,2014,44,0,1,0,0,1,34,11,10,0,0,21,100,22,134,16.4
299,Wisconsin,2014,21,5,4,0,0,9,33,17,8,0,0,25,99,34,132,25.8
300,Wyoming,2014,46,1,1,0,0,2,30,2,10,0,0,12,60,14,90,15.6
301,Alabama,2013,47,4,0,1,0,5,35,9,5,0,0,14,105,19,140,13.6
302,Alaska,2013,14,1,0,3,0,4,20,3,10,0,0,13,40,17,60,28.3
303,Arizona,2013,3,7,6,0,0,13,30,11,8,0,0,19,60,32,90,35.6
304,Arkansas,2013,41,3,3,0,0,6,35,7,10,0,0,17,100,23,135,17
305,California,2013,19,10,2,0,0,12,40,13,7,0,0,20,80,32,120,26.7
306,Colorado,2013,2,11,2,0,0,13,35,18,10,0,0,28,65,41,100,41
307,Connecticut,2013,11,8,1,0,0,9,36,29,17,0,0,46,151,55,187,29.4
308,Deleware,2013,20,5,1,0,0,6,21,8,2,0,0,10,41,16,62,25.8
309,Florida,2013,23,6,6,0,0,12,40,16,13,0,0,29,120,41,160,25.6
310,Georgia,2013,28,7,1,0,0,8,56,29,16,0,0,45,180,53,236,22.5
311,Hawaii,2013,8,8,0,0,0,8,25,12,3,0,0,15,51,23,76,30.3
312,Idaho,2013,22,2,3,0,0,5,35,8,14,0,0,22,70,27,105,25.7
313,Illinois,2013,7,11,4,0,0,15,59,30,10,0,0,40,118,55,177,31.1
314,Indiana,2013,34,3,5,0,0,8,50,12,11,0,0,23,100,31,150,20.7
315,Iowa,2013,27,6,4,0,0,10,50,19,6,0,0,25,100,35,150,23.3
316,Kansas,2013,25,4,8,0,0,12,40,15,12,0,0,27,125,39,165,23.6
317,Kentucky,2013,40,2,4,0,0,6,38,10,8,0,0,18,100,24,138,17.4
318,Louisiana,2013,50,3,1,0,0,4,39,9,4,0,0,13,105,17,144,11.8
319,Maine,2013,10,8,0,0,0,8,35,34,13,0,0,47,151,55,186,29.6
320,Maryland,2013,8,10,1,0,0,11,47,34,12,0,0,46,141,57,188,30.3
321,Massachusetts,2013,24,12,0,0,0,12,40,32,7,0,0,39,160,51,200,25.5
322,Michigan,2013,36,2,2,0,0,4,38,16,8,0,0,24,110,28,148,18.9
323,Minnesota,2013,4,15,8,0,0,23,67,28,17,0,0,45,134,68,201,33.8
324,Mississippi,2013,38,2,6,0,0,8,52,16,7,0,0,23,122,31,174,17.8
325,Missouri,2013,31,5,0,0,0,5,34,19,19,0,0,38,163,43,197,21.8
326,Montana,2013,17,5,5,0,0,10,50,23,8,0,0,31,100,41,150,27.3
327,Nebraska*,2013,35,0,0,0,0,10,49,0,0,0,0,0,0,10,49,20.4
328,Nevada,2013,13,3,1,0,0,4,21,12,2,0,0,14,42,18,63,28.6
329,New Hampshire,2013,5,6,3,0,0,9,24,99,34,0,0,133,400,142,424,33.5
330,New Jersey,2013,12,8,3,0,0,11,40,15,9,0,0,24,80,35,120,29.2
331,New Mexico,2013,16,3,3,0,0,6,42,15,10,0,0,25,70,31,112,27.7
332,New York,2013,30,6,4,0,0,10,63,32,5,0,0,37,150,47,213,22.1
333,North Carolina,2013,31,3,4,0,0,7,50,17,13,0,0,30,120,37,170,21.8
334,North Dakota,2013,41,3,5,0,0,8,47,7,9,0,0,16,94,24,141,17
335,Ohio,2013,26,5,3,0,0,8,33,11,12,0,0,23,99,31,132,23.5
336,Oklahoma,2013,48,2,2,0,0,4,48,5,11,0,0,16,101,20,149,13.4
337,Oregon,2013,15,5,2,0,0,7,30,13,5,0,0,18,60,25,90,27.8
338,Pennsylvania,2013,38,5,3,0,0,8,50,16,21,0,0,37,203,45,253,17.8
339,Rhode Island,2013,19,9,0,0,0,9,38,19,2,0,0,21,75,30,113,26.5
340,South Carolina,2013,49,0,1,0,0,1,46,11,10,0,0,21,124,22,170,12.9
341,South Dakota,2013,28,1,5,0,0,6,35,6,12,0,0,18,70,24,105,22.9
342,Tennessee,2013,43,3,4,0,0,7,33,7,8,0,0,15,99,22,132,16.7
343,Texas,2013,33,4,3,0,0,7,31,16,15,0,0,31,150,38,181,21
344,Utah,2013,46,3,2,0,0,5,29,8,4,0,0,12,75,17,104,16.3
345,Vermont,2013,1,7,2,0,0,9,30,49,12,0,0,65,150,74,180,41.1
346,Virginia,2013,37,5,1,0,0,6,40,12,7,0,0,19,100,25,140,17.9
347,Washington,2013,6,10,8,0,0,18,49,20,9,0,0,29,98,47,147,32
348,West Virginia,2013,45,0,1,0,0,1,34,11,10,0,0,21,100,22,134,16.4
349,Wisconsin,2013,20,5,4,0,0,9,33,17,8,0,0,25,99,34,132,25.8
350,Wyoming,2013,43,1,1,0,0,2,30,2,11,0,0,13,60,15,90,16.7
351,Alabama,2012,47,4,0,1,0,5,35,9,5,0,0,14,105,19,140,13.6
352,Alaska,2012,21,1,0,3,0,4,20,4,7,0,0,11,40,15,60,25
353,Arizona,2012,4,4,7,0,0,11,30,7,12,0,0,19,60,30,90,33.3
354,Arkansas,2012,31,5,3,0,0,8,35,11,11,0,0,22,100,30,135,22.2
355,California,2012,13,9,3,0,0,12,40,16,6,0,0,22,80,34,120,28.3
356,Colorado,2012,1,14,3,0,0,17,35,14,9,0,0,23,65,40,100,40
357,Connecticut,2012,9,8,1,0,0,9,36,32,15,0,0,47,151,56,187,29.9
358,Deleware,2012,17,4,3,0,0,7,21,7,2,0,0,9,41,16,62,25.8
359,Florida,2012,19,7,7,0,0,14,40,12,15,0,0,27,120,41,160,25.6
360,Georgia,2012,27,8,1,0,0,9,56,30,17,0,0,47,180,56,236,23.7
361,Hawaii,2012,3,9,0,0,0,9,25,14,4,0,0,18,51,27,76,35.5
362,Idaho,2012,15,3,6,0,0,9,35,8,12,0,0,20,70,29,105,27.6
363,Illinois,2012,7,10,6,0,0,16,59,28,11,0,0,42,118,55,177,31.1
364,Indiana,2012,33,4,7,0,0,11,50,11,10,0,0,21,100,32,150,21.3
365,Iowa,2012,33,4,4,0,0,8,50,16,8,0,0,24,100,32,150,21.3
366,Kansas,2012,16,4,8,0,0,12,40,14,19,0,0,33,125,45,165,27.3
367,Kentucky,2012,38,3,3,0,0,6,38,11,9,0,0,20,100,26,138,18.8
368,Louisiana,2012,49,3,1,0,0,4,39,9,3,0,0,12,105,16,144,11.1
369,Maine,2012,11,5,3,0,0,8,35,27,19,0,0,46,151,54,186,29
370,Maryland,2012,8,10,1,0,0,11,47,35,12,0,0,47,141,58,188,30.9
371,Massachusetts,2012,24,11,0,0,0,11,40,32,6,0,0,38,160,49,200,24.5
372,Michigan,2012,36,2,2,0,0,4,38,16,11,0,0,27,110,31,148,20.9
373,Minnesota,2012,5,11,10,0,0,21,67,27,18,0,0,45,134,66,201,32.8
374,Mississippi,2012,44,1,6,0,0,7,52,15,6,0,0,21,122,28,174,16.1
375,Missouri,2012,27,4,2,0,0,6,34,23,18,0,0,41,163,47,197,23.9
376,Montana,2012,26,6,2,0,0,8,50,19,9,0,0,28,100,36,150,24
377,Nebraska*,2012,30,0,0,0,0,11,49,0,0,0,0,0,0,11,49,22.4
378,Nevada,2012,20,3,1,0,0,4,21,11,1,0,0,12,42,16,63,25.4
379,New Hampshire,2012,23,3,3,0,0,6,24,40,58,0,0,98,400,104,424,24.5
380,New Jersey,2012,10,8,3,0,0,11,40,15,9,0,0,24,80,35,120,29.2
381,New Mexico,2012,14,9,2,0,0,11,42,12,8,0,0,20,70,31,112,27.7
382,New York,2012,31,8,3,0,0,11,63,29,7,0,0,36,150,47,213,22.2
383,North Carolina,2012,22,3,3,0,0,6,50,23,13,0,0,36,120,42,170,24.7
384,North Dakota,2012,45,3,4,0,0,7,47,3,12,0,0,15,94,22,141,15.6
385,Ohio,2012,29,5,3,0,0,8,33,12,11,0,0,23,99,31,132,23.5
386,Oklahoma,2012,48,3,2,0,0,5,48,4,10,0,0,14,101,19,149,12.8
387,Oregon,2012,12,7,2,0,0,9,30,12,5,0,0,17,60,26,90,28.9
388,Pennsylvania,2012,42,5,5,0,0,10,50,14,19,0,0,33,203,43,253,17
389,Rhode Island,2012,18,9,1,0,0,10,38,17,2,0,0,19,75,29,113,25.7
390,South Carolina,2012,50,0,0,0,0,0,46,8,9,0,0,17,124,17,170,10
391,South Dakota,2012,37,1,6,0,0,7,35,4,10,0,0,14,70,21,105,20
392,Tennessee,2012,39,4,3,0,0,7,33,11,6,0,0,17,99,24,132,18.2
393,Texas,2012,35,3,3,0,0,6,31,13,19,0,0,32,150,38,181,21
394,Utah,2012,43,4,1,0,0,5,29,8,4,0,0,12,75,17,104,16.3
395,Vermont,2012,2,9,2,0,0,11,30,44,11,0,0,59,150,70,180,38.9
396,Virginia,2012,41,5,1,0,0,6,40,11,7,0,0,18,100,24,140,17.1
397,Washington,2012,6,12,6,0,0,18,49,19,10,0,0,29,98,47,147,32
398,West Virginia,2012,40,0,2,0,0,2,34,15,7,0,0,22,100,24,134,17.9
399,Wisconsin,2012,25,5,4,0,0,9,33,16,7,0,0,23,99,32,132,24.2
400,Wyoming,2012,45,0,1,0,0,1,30,3,10,0,0,13,60,14,90,15.6
401,Alabama,2011,48,4,0,1,0,5,35,9,5,0,0,14,105,19,140,13.6
402,Alaska,2011,27,1,0,3,0,4,20,4,6,0,0,10,40,14,60,23.3
403,Arizona,2011,3,5,6,0,0,11,30,7,13,0,0,20,60,31,90,34.4
404,Arkansas,2011,31,5,3,0,0,8,35,12,10,0,0,22,100,30,135,22.2
405,California,2011,12,9,3,0,0,12,40,16,6,0,0,22,80,34,120,28.3
406,Colorado,2011,1,14,3,0,0,17,35,15,9,0,0,24,65,41,100,41
407,Connecticut,2011,9,8,1,0,0,9,36,32,15,0,0,47,151,56,187,29.9
408,Deleware,2011,18,4,3,0,0,7,21,7,2,0,0,9,41,16,62,25.8
409,Florida,2011,21,7,7,0,0,14,40,11,15,0,0,27,120,41,160,25.6
410,Georgia,2011,26,8,1,0,0,9,56,30,17,0,0,47,180,56,236,23.7
411,Hawaii,2011,4,9,0,0,0,9,25,13,4,0,0,17,51,26,76,34.2
412,Idaho,2011,15,3,6,0,0,9,35,8,12,0,0,20,70,29,105,27.6
413,Illinois,2011,7,10,6,0,0,16,59,28,11,0,0,39,118,55,177,31.1
414,Indiana,2011,32,4,7,0,0,11,50,11,10,0,0,21,100,32,150,21.3
415,Iowa,2011,32,4,4,0,0,8,50,16,8,0,0,24,100,32,150,21.3
416,Kansas,2011,16,4,8,0,0,12,40,14,19,0,0,33,125,45,165,27.3
417,Kentucky,2011,39,3,3,0,0,6,38,11,9,0,0,20,100,26,138,18.8
418,Louisiana,2011,44,6,2,0,0,8,39,11,4,0,0,15,105,23,144,16
419,Maine,2011,10,5,3,0,0,8,35,27,19,0,0,46,151,54,186,29
420,Maryland,2011,8,10,1,0,0,11,47,35,12,0,0,47,141,58,188,30.9
421,Massachusetts,2011,23,11,0,0,0,11,40,32,6,0,0,38,160,49,200,24.5
422,Michigan,2011,36,2,2,0,0,4,38,16,11,0,0,27,110,31,148,20.9
423,Minnesota,2011,6,9,10,0,0,19,67,26,18,0,0,44,134,63,201,31.3
424,Mississippi,2011,45,3,2,0,0,5,52,17,4,0,0,21,122,26,174,14.9
425,Missouri,2011,25,4,2,0,0,6,34,22,18,1,0,41,163,47,197,23.9
426,Montana,2011,24,6,2,0,0,8,50,19,9,0,0,28,100,36,150,24
427,Nebraska*,2011,29,0,0,0,0,11,49,0,0,0,0,0,0,11,49,22.4
428,Nevada,2011,11,4,2,0,0,6,21,11,1,0,0,12,42,18,63,28.6
429,New Hampshire,2011,22,3,3,0,0,6,24,40,59,0,0,99,400,105,424,24.8
430,New Jersey,2011,12,7,3,0,0,10,40,15,9,0,0,24,80,34,120,28.3
431,New Mexico,2011,17,8,2,0,0,10,42,12,8,0,0,20,70,30,112,26.8
432,New York,2011,34,8,3,0,0,11,62,27,7,0,0,34,150,45,212,21.2
433,North Carolina,2011,29,3,3,0,0,6,50,22,10,0,0,32,120,38,170,22.4
434,North Dakota,2011,45,3,3,0,0,6,47,3,12,0,0,15,94,21,141,14.9
435,Ohio,2011,28,5,3,0,0,8,33,12,10,0,0,22,99,30,132,22.7
436,Oklahoma,2011,49,3,1,0,0,4,48,4,11,0,0,15,101,19,149,12.8
437,Oregon,2011,14,6,2,0,0,8,30,12,5,0,0,17,60,25,90,27.8
438,Pennsylvania,2011,42,5,6,0,0,11,50,14,19,0,0,33,203,44,253,17.4
439,Rhode Island,2011,20,9,1,0,0,10,38,17,2,0,0,19,75,29,113,25.7
440,South Carolina,2011,50,0,0,0,0,0,46,8,8,0,0,16,124,16,170,9.4
441,South Dakota,2011,37,6,1,0,0,7,35,4,9,1,0,14,70,21,105,20
442,Tennessee,2011,40,4,3,0,0,7,33,11,6,0,0,17,99,24,132,18.2
443,Texas,2011,35,3,3,0,0,6,31,14,18,0,0,32,150,38,181,21
444,Utah,2011,43,4,1,0,0,5,29,8,5,0,0,13,75,18,104,17.3
445,Vermont,2011,2,9,2,0,0,11,30,43,11,0,0,58,150,69,180,38.3
446,Virginia,2011,38,7,1,0,0,8,40,13,6,0,0,19,100,27,140,19.3
447,Washington,2011,5,12,6,0,0,18,49,19,10,0,0,29,98,47,147,32
448,West Virginia,2011,41,0,2,0,0,2,34,15,7,0,0,22,100,24,134,17.9
449,Wisconsin,2011,19,5,5,0,0,10,33,16,8,0,0,24,99,34,132,25.8
450,Wyoming,2011,47,0,1,0,0,1,30,3,9,0,0,12,60,13,90,14.4
451,Alabama,2010,48,4,0,1,0,5,35,10,3,0,0,13,105,18,140,12.9
452,Alaska,2010,34,1,0,2,0,3,20,4,6,0,0,10,40,13,60,21.7
453,Arizona,2010,7,7,4,0,0,11,30,9,9,0,0,18,60,29,90,32.2
454,Arkansas,2010,28,4,2,0,0,6,35,16,9,0,0,25,100,31,135,23
455,California,2010,17,11,1,0,0,12,40,16,4,0,0,20,80,32,120,26.7
456,Colorado,2010,1,12,1,0,0,13,35,19,6,0,0,25,65,38,100,38
457,Connecticut,2010,8,7,1,0,0,8,36,40,12,0,0,52,151,60,187,32.1
458,Deleware,2010,20,5,3,0,0,8,21,5,3,0,0,8,41,16,62,25.8
459,Florida,2010,25,5,4,0,0,9,40,15,14,0,0,29,120,38,160,23.8
460,Georgia,2010,38,7,1,0,0,8,56,27,11,0,0,38,180,46,236,19.5
461,Hawaii,2010,5,7,0,0,0,7,25,13,5,0,0,18,51,25,76,32.9
462,Idaho,2010,21,4,5,0,0,9,35,11,7,0,0,18,70,27,105,25.7
463,Illinois,2010,16,10,3,0,0,13,59,25,12,0,0,37,118,50,177,28.2
464,Indiana,2010,35,6,6,0,0,12,50,13,7,0,0,20,100,32,150,21.3
465,Iowa,2010,27,6,3,0,0,9,50,20,6,0,0,26,100,35,150,23.3
466,Kansas,2010,12,5,9,0,0,14,40,21,15,0,0,36,125,50,165,30.3
467,Kentucky,2010,45,3,4,0,0,7,38,11,4,0,0,15,100,22,138,15.9
468,Louisiana,2010,44,6,2,0,0,8,39,11,4,0,0,15,105,23,144,16
469,Maine,2010,13,6,2,0,0,8,35,36,10,0,0,46,151,54,186,29
470,Maryland,2010,10,9,1,0,0,10,47,38,11,0,0,49,141,59,188,31.4
471,Massachusetts,2010,22,12,0,0,0,12,40,36,3,0,0,39,160,51,200,25.5
472,Michigan,2010,23,6,3,0,0,9,38,22,6,0,0,28,110,37,148,25
473,Minnesota,2010,4,19,8,0,0,27,67,33,10,0,0,43,134,70,201,34.8
474,Mississippi,2010,47,3,1,0,0,4,52,17,4,0,0,21,122,25,174,14.4
475,Missouri,2010,29,5,3,0,0,8,34,26,10,0,0,36,163,44,197,22.3
476,Montana,2010,18,8,2,0,0,10,50,23,6,0,0,29,100,39,150,26
477,Nebraska*,2010,36,0,0,0,0,10,49,0,0,0,0,0,0,10,49,20.4
478,Nevada,2010,9,6,1,0,0,7,21,11,2,0,0,13,42,20,63,31.7
479,New Hampshire,2010,3,11,2,0,0,13,24,101,42,0,0,143,400,156,424,36.8
480,New Jersey,2010,15,7,3,0,0,10,40,16,8,0,0,24,80,34,120,28.3
481,New Mexico,2010,11,8,3,0,0,11,42,13,10,0,0,23,70,34,112,30.4
482,New York,2010,24,8,2,0,0,10,62,35,6,0,0,41,150,51,212,24.1
483,North Carolina,2010,19,4,2,0,0,6,50,26,12,0,0,38,120,44,170,25.9
484,North Dakota,2010,43,4,2,0,0,6,47,7,10,0,0,17,94,23,141,16.3
485,Ohio,2010,32,5,2,0,0,7,33,17,5,0,0,22,99,29,132,22
486,Oklahoma,2010,49,5,0,0,0,5,48,3,9,0,0,12,101,17,149,11.4
487,Oregon,2010,14,8,2,0,0,10,30,13,3,0,0,16,60,26,90,28.9
488,Pennsylvania,2010,46,4,6,0,0,10,50,11,18,0,0,29,203,39,253,15.4
489,Rhode Island,2010,30,8,0,0,0,8,38,17,0,0,0,17,75,25,113,22.1
490,South Carolina,2010,50,0,0,0,0,0,46,8,9,0,0,17,124,17,170,10
491,South Dakota,2010,37,6,1,0,0,7,35,5,9,0,0,14,70,21,105,20
492,Tennessee,2010,40,4,4,0,0,8,33,12,5,0,0,17,99,25,132,18.9
493,Texas,2010,25,3,3,0,0,6,31,24,13,0,0,37,150,43,181,23.8
494,Utah,2010,30,4,1,0,0,5,29,11,7,0,0,18,75,23,104,22.1
495,Vermont,2010,2,9,2,0,0,11,30,42,10,0,0,56,150,67,180,37.2
496,Virginia,2010,39,7,1,0,0,8,40,13,6,0,0,19,100,27,140,19.3
497,Washington,2010,6,13,6,0,0,19,49,21,8,0,0,29,98,48,147,32.7
498,West Virginia,2010,42,0,2,0,0,2,34,15,5,0,0,20,100,22,134,16.4
499,Wisconsin,2010,32,4,3,0,0,7,33,16,6,0,0,22,99,29,132,22
500,Wyoming,2010,41,2,0,0,0,2,30,6,7,0,0,13,60,15,90,16.7
501,Alabama,2009,48,4,1,0,0,5,35,10,3,0,0,13,105,18,140,12.9
502,Alaska,2009,32,1,0,2,0,3,20,4,6,0,0,10,40,13,60,21.7
503,Arizona,2009,9,7,5,0,0,12,30,9,7,0,0,16,60,28,90,31.1
504,Arkansas,2009,28,4,2,0,0,6,35,16,9,0,0,25,100,31,135,23
505,California,2009,16,12,1,0,0,13,40,16,4,0,0,20,80,33,120,27.5
506,Colorado,2009,3,11,1,0,0,12,35,19,6,0,0,25,65,37,100,37
507,Connecticut,2009,8,7,1,0,0,8,36,40,11,0,0,51,151,59,187,31.6
508,Deleware,2009,21,5,3,0,0,8,21,5,3,0,0,8,41,16,62,25.8
509,Florida,2009,27,5,4,0,0,9,40,14,14,0,0,28,120,37,160,623.1
510,Georgia,2009,38,7,1,0,0,8,56,27,11,0,0,38,180,46,236,19.55
511,Hawaii,2009,5,7,0,0,0,7,25,13,5,0,0,18,51,25,76,32.9
512,Idaho,2009,23,3,5,0,0,8,35,11,7,0,0,18,70,26,105,24.8
513,Illinois,2009,15,10,3,0,0,13,59,25,11,0,0,36,118,49,177,27.7
514,Indiana,2009,33,6,6,0,0,12,50,13,7,0,0,20,100,32,150,21.3
515,Iowa,2009,26,6,3,0,0,9,50,20,6,0,0,26,100,35,150,23.3
516,Kansas,2009,13,5,8,0,0,13,40,20,15,0,0,35,125,48,165,29.1
517,Kentucky,2009,45,3,4,0,0,7,38,11,4,0,0,15,100,22,138,15.9
518,Louisiana,2009,44,6,2,0,0,8,39,11,4,0,0,15,105,23,144,16
519,Maine,2009,14,6,2,0,0,8,35,36,10,0,0,46,151,54,186,29
520,Maryland,2009,10,9,1,0,0,10,47,38,10,0,0,48,141,58,188,30.9
521,Massachusetts,2009,18,12,0,0,0,12,40,37,3,0,0,40,160,52,200,26
522,Michigan,2009,22,6,3,0,0,9,38,22,6,0,0,28,110,37,148,25
523,Minnesota,2009,4,19,8,0,0,27,67,33,10,0,0,43,134,70,201,34.8
524,Mississippi,2009,47,3,1,0,0,4,52,17,4,0,0,21,122,25,174,14.4
525,Missouri,2009,33,5,3,0,0,8,34,25,9,0,0,34,163,42,197,21.3
526,Montana,2009,18,8,2,0,0,10,50,23,6,0,0,29,100,39,150,26
527,Nebraska*,2009,36,0,0,0,0,10,49,0,0,0,0,0,0,10,49,20.4
528,Nevada,2009,7,6,1,0,0,7,21,11,2,0,0,13,42,20,63,31.7
529,New Hampshire,2009,1,11,2,0,0,13,24,103,43,0,0,146,400,159,424,37.5
530,New Jersey,2009,12,6,2,0,0,8,40,19,9,0,0,28,80,36,120,30
531,New Mexico,2009,11,8,3,0,0,11,42,13,10,0,0,23,70,34,112,30.4
532,New York,2009,24,8,2,0,0,10,62,36,6,0,0,42,150,52,212,24.5
533,North Carolina,2009,20,4,2,0,0,6,50,26,12,0,0,38,120,44,170,25.9
534,North Dakota,2009,43,4,2,0,0,6,47,7,10,0,0,17,94,23,141,16.3
535,Ohio,2009,35,5,2,0,0,7,33,16,5,0,0,21,99,28,132,21.2
536,Oklahoma,2009,49,5,0,0,0,5,48,3,9,0,0,12,101,17,149,11.4
537,Oregon,2009,17,8,1,0,0,9,30,12,3,0,0,15,60,24,90,26.7
538,Pennsylvania,2009,46,4,6,0,0,10,50,11,16,0,0,27,203,37,253,14.6
539,Rhode Island,2009,29,8,0,0,0,8,38,17,0,0,0,17,75,25,113,22.1
540,South Carolina,2009,50,0,0,0,0,0,46,9,8,0,0,17,124,17,170,10
541,South Dakota,2009,37,6,1,0,0,7,35,5,9,0,0,14,70,21,105,20
542,Tennessee,2009,39,4,4,0,0,8,33,11,5,0,0,16,99,24,132,18.2
543,Texas,2009,25,3,3,0,0,6,31,24,13,0,0,37,150,43,181,23.8
544,Utah,2009,29,4,1,0,0,5,29,11,7,0,0,18,75,23,104,22.1
545,Vermont,2009,2,9,1,0,0,10,30,42,11,0,0,57,150,67,180,37.2
546,Virginia,2009,40,7,1,0,0,8,40,12,4,0,0,16,100,24,140,17.1
547,Washington,2009,6,13,6,0,0,19,49,22,7,0,0,29,98,48,147,32.7
548,West Virginia,2009,42,0,2,0,0,2,34,15,5,0,0,20,100,22,134,16.4
549,Wisconsin,2009,31,4,3,0,0,7,33,16,6,0,0,22,99,29,132,22
550,Wyoming,2009,41,2,0,0,0,2,30,6,7,0,0,13,60,15,90,16.7
551,Alabama,2008,48,3,1,0,0,4,35,11,3,0,0,14,105,18,140,12.9
552,Alaska,2008,28,1,0,2,0,3,20,6,4,0,0,10,40,13,60,21.7
553,Arizona,2008,6,8,6,0,0,14,30,9,8,0,0,17,60,31,90,34.4
554,Arkansas,2008,29,4,2,0,0,6,35,18,4,0,0,22,100,28,135,20.7
555,California,2008,17,10,0,0,0,10,40,17,6,0,0,23,80,33,120,27.5
556,Colorado,2008,2,9,1,0,0,10,35,21,5,0,0,26,65,36,100,36
557,Connecticut,2008,16,7,1,0,0,8,36,31,14,0,0,45,151,53,187,28.3
558,Deleware,2008,11,4,3,0,0,7,21,7,5,0,0,12,41,19,62,30.6
559,Florida,2008,25,6,4,0,0,10,40,16,11,0,0,27,120,37,160,23.1
560,Georgia,2008,31,6,2,0,0,8,56,29,10,0,0,39,180,47,236,19.9
561,Hawaii,2008,7,7,0,0,0,7,25,11,7,0,0,18,51,25,76,32.9
562,Idaho,2008,22,2,4,0,0,6,35,12,7,0,0,19,70,25,105,23.8
563,Illinois,2008,18,10,3,0,0,13,59,23,12,0,0,35,118,48,177,27.1
564,Indiana,2008,36,6,6,0,0,12,50,10,6,0,0,16,100,28,150,18.7
565,Iowa,2008,26,3,3,0,0,6,50,19,9,0,0,28,100,34,150,22.7
566,Kansas,2008,15,4,9,0,0,13,40,19,16,0,0,35,125,48,165,29.1
567,Kentucky,2008,47,1,4,0,0,5,38,10,3,0,0,13,100,18,138,13
568,Louisiana,2008,43,6,2,0,0,8,39,10,4,0,0,14,105,22,144,15.3
569,Maine,2008,10,7,5,0,0,12,35,35,11,0,0,46,151,58,186,31.2
570,Maryland,2008,9,9,2,0,0,11,47,38,10,0,0,48,141,59,188,31.4
571,Massachusetts,2008,20,12,0,0,0,12,40,34,4,0,0,38,160,50,200,25
572,Michigan,2008,32,6,3,0,0,9,38,16,4,0,0,20,110,29,148,19.6
573,Minnesota,2008,5,19,8,0,0,27,67,35,8,0,0,43,134,70,201,34.8
574,Mississippi,2008,45,3,1,0,0,4,52,17,4,0,0,21,122,25,174,14.4
575,Missouri,2008,30,5,2,0,0,7,34,23,10,0,0,33,163,40,197,20.3
576,Montana,2008,21,8,1,0,0,9,50,20,8,0,0,28,100,37,150,24.7
577,Nebraska*,2008,37,0,0,0,0,9,49,0,0,0,0,0,0,9,49,18.4
578,Nevada,2008,13,5,1,0,0,6,21,10,3,0,0,13,42,19,63,30.2
579,New Hampshire,2008,3,9,1,0,0,10,24,99,40,1,0,140,400,150,424,35.4
580,New Jersey,2008,14,7,2,0,0,9,40,18,8,0,0,26,80,35,120,29.2
581,New Mexico,2008,12,8,4,0,0,12,42,10,12,0,0,22,70,34,112,30.4
582,New York,2008,23,8,3,0,0,11,62,34,5,0,0,39,150,50,212,23.6
583,North Carolina,2008,19,6,1,0,0,7,50,26,12,0,0,38,120,45,170,26.5
584,North Dakota,2008,41,4,2,0,0,6,47,7,11,0,0,18,94,24,141,17
585,Ohio,2008,38,5,1,0,0,6,33,12,6,0,0,18,99,24,132,18.2
586,Oklahoma,2008,49,6,1,0,0,7,48,3,9,0,0,12,101,19,149,12.8
587,Oregon,2008,8,8,1,1,0,10,30,11,8,0,0,19,60,29,90,32.2
588,Pennsylvania,2008,44,5,5,0,0,10,50,11,16,0,0,27,203,37,253,14.6
589,Rhode Island,2008,33,6,1,0,0,7,38,13,2,0,0,15,75,22,113,19.5
590,South Carolina,2008,50,1,1,0,0,2,46,8,5,0,0,13,124,15,170,8.8
591,South Dakota,2008,40,4,1,0,0,5,35,3,10,0,0,13,70,18,105,17.1
592,Tennessee,2008,39,5,3,0,0,8,33,10,5,0,0,15,99,23,132,17.4
593,Texas,2008,35,2,2,0,0,4,31,18,12,0,0,30,150,34,181,18.8
594,Utah,2008,34,2,2,0,0,4,29,9,7,0,0,16,75,20,104,19.2
595,Vermont,2008,1,9,1,0,0,10,30,41,15,0,0,59,150,69,180,38.3
596,Virginia,2008,42,7,1,0,0,8,40,10,5,0,0,15,100,23,140,16.4
597,Washington,2008,3,15,5,0,0,20,49,23,9,0,0,32,98,52,147,35.4
598,West Virginia,2008,46,0,2,0,0,2,34,12,5,0,0,17,100,19,134,14.2
599,Wisconsin,2008,27,4,3,0,0,7,33,13,9,0,0,22,99,29,132,22
600,Wyoming,2008,24,3,1,0,0,4,30,8,9,0,0,17,60,21,90,23.3
601,Wyoming,2007,23,3,1,0,0,4,30,8,9,0,0,17,60,21,90,23.3
602,Wisconsin,2007,25,4,4,0,0,8,33,13,9,0,0,22,99,30,132,22.7
603,West Virginia,2007,45,0,2,0,0,2,34,12,5,0,0,17,100,19,134,14.2
604,Washington,2007,4,15,5,0,0,20,49,22,8,0,0,30,98,50,147,34
605,Virginia,2007,40,7,1,0,0,8,40,9,6,1,0,16,100,24,140,17.1
606,Vermont,2007,1,9,1,0,0,10,30,41,14,0,0,58,150,68,180,37.8
607,Utah,2007,39,1,2,0,0,3,29,8,7,0,0,15,75,18,104,17.3
608,Texas,2007,33,2,2,0,0,4,31,18,13,0,0,31,150,35,181,19.3
609,Tennessee,2007,42,5,3,0,0,8,33,9,5,0,0,14,99,22,132,16.7
610,South Dakota,2007,40,4,1,0,0,5,35,3,10,0,0,13,70,18,105,17.1
611,South Carolina,2007,50,1,1,0,0,2,46,8,5,0,0,13,124,15,170,8.8
612,Rhode Island,2007,31,6,1,0,0,7,38,13,2,0,0,15,75,22,113,19.5
613,Pennsylvania,2007,44,5,5,0,0,10,50,11,16,0,0,27,203,37,253,14.6
614,Oregon,2007,10,8,1,0,0,9,30,12,7,0,0,19,60,28,90,31.1
615,Oklahoma,2007,48,6,1,0,0,7,48,3,9,0,0,12,101,19,149,12.8
616,Ohio,2007,43,4,1,0,0,5,33,11,5,0,0,16,99,21,132,15.9
617,North Dakota,2007,37,4,2,0,0,6,47,7,12,0,0,19,94,25,141,17.7
618,North Carolina,2007,18,6,1,0,0,7,50,25,12,0,0,37,120,44,170,25.9
619,New York,2007,21,8,3,0,0,11,62,35,5,0,0,40,150,51,212,24.1
620,New Mexico,2007,12,8,4,0,0,12,42,10,12,0,0,22,70,34,112,30.4
621,New Jersey,2007,27,6,2,0,0,8,40,13,5,0,0,18,80,26,120,21.7
622,New Hampshire,2007,2,9,1,0,0,10,24,100,40,1,0,141,400,151,424,35.6
623,Nevada,2007,13,5,1,0,0,6,21,10,3,0,0,13,42,19,63,30.2
624,Nebraska*,2007,36,0,0,0,0,9,49,0,0,0,0,0,0,9,49,18.4
625,Montana,2007,19,8,1,0,0,9,50,20,8,0,0,28,100,37,150,24.7
626,Missouri,2007,33,5,2,0,0,7,34,22,9,0,0,31,163,38,197,19.3
627,Mississippi,2007,46,4,1,0,0,5,52,15,4,0,0,19,122,24,174,13.8
628,Minnesota,2007,3,18,9,0,0,27,67,35,8,0,0,43,134,70,201,34.8
629,Michigan,2007,30,6,3,0,0,9,38,16,4,0,0,20,110,29,148,19.6
630,Massachusetts,2007,20,12,0,0,0,12,40,33,4,0,0,37,160,49,200,24.5
631,Maryland,2007,8,10,2,0,0,12,47,38,10,0,0,48,141,60,188,31.9
632,Maine,2007,9,7,5,0,0,12,35,35,11,0,0,46,151,58,186,31.2
633,Louisiana,2007,38,5,2,0,0,7,39,13,5,0,0,18,105,25,144,17.4
634,Kentucky,2007,49,1,4,0,0,5,38,9,2,0,0,11,100,16,138,11.6
635,Kansas,2007,14,4,9,0,0,13,40,19,16,0,0,35,125,48,165,29.1
636,Iowa,2007,25,3,3,0,0,6,50,19,9,0,0,28,100,34,150,22.7
637,Indiana,2007,33,6,6,0,0,12,50,11,6,0,0,17,100,29,150,19.3
638,Illinois,2007,17,10,3,0,0,13,59,23,12,0,0,35,118,48,177,27.1
639,Idaho,2007,22,2,4,0,0,6,35,12,7,0,0,19,70,25,105,23.8
640,Hawaii,2007,7,7,0,0,0,7,25,11,7,0,0,18,51,25,76,32.9
641,Georgia,2007,31,6,2,0,0,8,56,28,10,0,0,38,180,46,236,19.5
642,Florida,2007,24,6,4,0,0,10,40,16,11,0,0,27,120,37,160,23.1
643,Deleware,2007,11,4,3,0,0,7,21,7,5,0,0,12,41,19,62,30.6
644,Connecticut,2007,15,7,1,0,0,8,36,31,14,0,0,45,151,53,187,28.3
645,Colorado,2007,4,9,1,0,0,10,35,19,5,0,0,24,65,34,100,34
646,California,2007,16,10,0,0,0,10,40,17,6,0,0,23,80,33,120,27.5
647,Arkansas,2007,29,4,2,0,0,6,35,18,4,0,0,22,100,28,135,20.7
648,Arizona,2007,6,8,5,0,0,13,30,9,8,0,0,17,60,30,90,33.3
649,Alaska,2007,27,1,0,2,0,3,20,6,4,0,0,10,40,13,60,21.7
650,Alabama,2006,49,2,1,0,0,3,35,11,2,0,0,13,105,16,140,11.4
651,Alaska,2006,34,2,0,1,0,3,20,4,4,0,0,8,40,11,60,18.3
652,Arizona,2006,3,4,5,0,0,9,30,10,11,0,0,21,60,30,90,33.3
653,Arkansas,2006,39,4,2,0,0,6,35,13,4,0,0,17,100,23,135,17
654,California,2006,12,12,0,0,0,12,40,19,6,0,0,25,80,37,120,30.8
655,Colorado,2006,8,9,2,0,0,11,35,17,4,0,0,21,65,32,100,32
656,Connecticut,2006,14,7,2,0,0,9,36,27,18,0,0,45,151,54,187,28.9
657,Deleware,2006,2,4,3,0,0,7,21,7,7,0,0,14,41,21,62,33.9
658,Florida,2006,22,5,4,0,0,9,40,12,18,0,0,30,120,39,160,24.4
659,Georgia,2006,33,5,2,0,0,7,56,28,9,0,0,37,180,44,236,18.6
660,Hawaii,2006,9,6,0,0,0,6,25,11,7,0,0,18,51,24,76,31.6
661,Idaho,2006,16,1,3,0,0,4,35,9,16,0,0,25,70,29,105,27.6
662,Illinois,2006,17,9,5,0,0,14,59,24,10,0,0,34,118,48,177,27.1
663,Indiana,2006,35,6,6,0,0,12,50,8,7,0,0,15,100,27,150,18
664,Iowa,2006,30,1,4,0,0,5,50,17,8,0,0,25,100,30,150,20
665,Kansas,2006,7,4,9,0,0,13,40,18,22,0,0,40,125,53,165,32.1
666,Kentucky,2006,48,1,4,0,0,5,38,8,3,0,0,11,100,16,138,11.6
667,Louisiana,2006,36,5,2,0,0,7,39,13,5,0,0,18,105,25,144,17.4
668,Maine,2006,23,6,5,0,0,11,35,24,8,0,0,32,151,43,186,23.1
669,Maryland,2006,1,12,3,0,0,15,47,40,12,0,0,52,141,67,188,35.6
670,Massachusetts,2006,19,11,0,0,0,11,40,34,6,0,0,40,160,51,200,25.5
671,Michigan,2006,29,6,6,0,0,12,38,12,6,0,0,18,110,30,148,20.3
672,Minnesota,2006,10,13,12,1,0,26,67,26,11,0,0,37,134,63,201,31.3
673,Mississippi,2006,46,4,0,0,0,4,52,15,5,0,0,20,122,24,174,13.8
674,Missouri,2006,26,4,2,0,0,6,34,26,10,0,0,36,163,42,197,21.3
675,Montana,2006,20,6,1,0,0,7,50,22,8,0,0,30,100,37,150,24.7
676,Nebraska*,2006,21,0,0,0,0,12,49,0,0,0,0,0,0,12,49,24.5
677,Nevada,2006,3,4,2,0,0,6,21,11,4,0,0,15,42,21,63,33.3
678,New Hampshire,2006,13,4,1,0,0,5,24,70,54,0,0,124,400,129,424,30.4
679,New Jersey,2006,31,5,2,0,0,7,40,11,5,0,0,16,80,23,120,19.2
680,New Mexico,2006,10,7,4,0,0,11,42,12,12,0,0,24,70,35,112,31.3
681,New York,2006,25,7,3,0,0,10,62,33,5,0,0,38,150,48,212,22.6
682,North Carolina,2006,24,7,0,0,0,7,50,22,10,0,0,32,120,39,170,22.9
683,North Dakota,2006,41,3,2,0,0,5,47,7,11,0,0,18,94,23,141,16.3
684,Ohio,2006,32,3,2,0,0,5,33,13,7,0,0,20,99,25,132,18.9
685,Oklahoma,2006,45,7,1,0,0,8,48,5,9,0,0,14,101,22,149,14.8
686,Oregon,2006,15,8,1,0,0,9,30,8,8,0,0,16,60,25,90,27.8
687,Pennsylvania,2006,47,5,4,0,0,9,50,9,16,0,0,25,203,34,253,13.4
688,Rhode Island,2006,40,7,1,0,0,8,38,9,2,0,0,11,75,19,113,16.8
689,South Carolina,2006,50,1,0,0,0,1,46,7,7,0,0,14,124,15,170,8.8
690,South Dakota,2006,42,2,1,0,0,3,35,4,10,0,0,14,70,17,105,16.2
691,Tennessee,2006,36,4,3,0,0,7,33,11,5,0,0,16,99,23,132,17.4
692,Texas,2006,28,2,2,0,0,4,31,15,18,0,0,33,150,37,181,20.4
693,Utah,2006,27,2,2,0,0,4,29,8,10,0,0,18,75,22,104,21.2
694,Vermont,2006,3,8,2,0,0,10,30,34,14,0,0,50,150,60,180,33.3
695,Virginia,2006,38,7,1,0,0,8,40,9,6,1,0,16,100,24,140,17.1
696,Washington,2006,3,15,5,0,0,20,49,19,10,0,0,29,98,49,147,33.3
697,West Virginia,2006,42,0,3,0,0,3,34,12,6,0,0,18,100,21,134,15.7
698,Wisconsin,2006,18,3,5,0,0,8,33,12,14,0,0,26,99,34,132,25.8
699,Alabama,2007,47,3,1,0,0,4,35,11,3,0,0,14,105,18,140,12.9
700,Wyoming,2006,44,3,1,0,0,4,30,4,6,0,0,10,60,14,90,15.6
701,Alabama,2005,49,2,1,0,0,3,35,10,2,0,0,12,105,15,140,10.7
702,Alaska,2005,32,2,0,1,0,3,20,4,4,0,0,8,40,11,60,18.3
703,Arizona,2005,3,4,6,0,0,10,30,10,10,0,0,20,60,30,90,33.3
704,Arkansas,2005,38,4,2,0,0,6,35,12,4,0,0,16,100,22,135,16.3
705,California,2005,10,12,0,0,0,12,40,19,6,0,0,25,80,37,120,30.8
706,Colorado,2005,7,9,2,0,0,11,35,18,4,0,0,22,65,33,100,33
707,Connecticut,2005,14,7,2,0,0,9,36,28,18,0,0,46,151,55,187,29.4
708,Deleware,2005,2,4,3,0,0,7,21,7,7,0,0,14,41,21,62,33.9
709,Florida,2005,22,5,4,0,0,9,40,13,17,0,0,30,120,39,160,24.4
710,Georgia,2005,33,5,2,0,0,7,56,27,9,0,0,36,180,43,236,18.2
711,Hawaii,2005,12,6,0,0,0,6,25,11,6,0,0,17,51,23,76,30.3
712,Idaho,2005,17,1,3,0,0,4,35,9,16,0,0,25,70,29,105,27.6
713,Illinois,2005,16,9,5,0,0,14,59,24,11,0,0,35,118,49,177,27.7
714,Indiana,2005,36,6,6,0,0,12,50,7,7,0,0,14,100,26,150,17.3
715,Iowa,2005,29,1,4,0,0,5,50,17,8,0,0,25,100,30,150,20
716,Kansas,2005,8,4,9,0,0,13,40,18,23,0,0,41,125,54,165,32.7
717,Kentucky,2005,48,1,5,0,0,6,38,8,3,0,0,11,100,17,138,12.3
718,Louisiana,2005,34,5,2,0,0,7,39,13,5,0,0,18,105,25,144,17.4
719,Maine,2005,23,6,5,0,0,11,35,24,8,0,0,32,151,43,186,23.1
720,Maryland,2005,1,12,3,0,0,15,47,40,12,0,0,52,141,67,188,35.6
721,Massachusetts,2005,19,11,0,0,0,11,40,33,6,0,0,39,160,50,200,25
722,Michigan,2005,27,5,6,0,0,11,38,13,6,0,0,19,110,30,148,20.3
723,Minnesota,2005,13,11,11,1,0,23,67,26,11,0,0,37,134,60,201,29.9
724,Mississippi,2005,47,4,0,0,0,4,52,13,5,0,0,18,122,22,174,12.6
725,Missouri,2005,26,4,2,0,0,6,34,25,10,0,0,35,163,41,197,20.8
726,Montana,2005,20,6,1,0,0,7,50,22,8,0,0,30,100,37,150,24.7
727,Nebraska*,2005,21,0,0,0,0,12,49,0,0,0,0,0,0,12,49,24.5
728,Nevada,2005,3,4,2,0,0,6,21,11,4,0,0,15,42,21,63,33.3
729,New Hampshire,2005,11,4,1,0,0,5,24,70,54,0,0,124,400,129,424,30.4
730,New Jersey,2005,41,5,2,0,0,7,40,9,3,0,0,12,80,19,120,15.8
731,New Mexico,2005,9,7,4,0,0,11,42,12,12,0,0,24,70,35,112,31.3
732,New York,2005,25,7,3,0,0,10,62,31,6,0,0,37,150,47,212,22.2
733,North Carolina,2005,24,7,0,0,0,7,50,22,10,0,0,32,120,39,170,22.9
734,North Dakota,2005,38,3,2,0,0,5,47,7,11,0,0,18,94,23,141,16.3
735,Ohio,2005,30,3,2,0,0,5,33,13,8,0,0,21,99,26,132,19.7
736,Oklahoma,2005,44,6,2,0,0,8,48,5,9,0,0,14,101,22,149,14.8
737,Oregon,2005,15,8,1,0,0,9,30,8,8,0,0,16,60,25,90,27.8
738,Pennsylvania,2005,46,5,4,0,0,9,50,9,16,0,0,25,203,34,253,13.4
739,Rhode Island,2005,37,7,1,0,0,8,38,9,2,0,0,11,75,19,113,16.8
740,South Carolina,2005,50,1,0,0,0,1,46,6,7,0,0,13,124,14,170,8.2
741,South Dakota,2005,40,2,1,0,0,3,35,4,10,0,0,14,70,17,105,16.2
742,Tennessee,2005,34,4,3,0,0,7,33,11,5,0,0,16,99,23,132,17.4
743,Texas,2005,31,2,2,0,0,4,31,13,18,0,0,31,150,35,181,19.3
744,Utah,2005,28,2,2,0,0,4,29,7,10,0,0,17,75,21,104,20.2
745,Vermont,2005,3,8,2,0,0,10,30,34,14,0,0,50,150,60,180,33.3
746,Virginia,2005,43,7,1,0,0,8,40,8,5,0,0,13,100,21,140,15
747,Washington,2005,3,15,5,0,0,20,49,19,10,0,0,29,98,49,147,33.3
748,West Virginia,2005,42,0,3,0,0,3,34,12,6,0,0,18,100,21,134,15.7
749,Wisconsin,2005,18,3,5,0,0,8,33,12,14,0,0,26,99,34,132,25.8
750,Wyoming,2005,45,3,1,0,0,4,30,4,5,0,0,9,60,13,90,14.4
751,Alabama,2004,49,2,1,0,0,3,35,9,2,0,0,11,105,14,140,10
752,Alaska,2004,32,3,0,1,0,4,20,3,5,0,0,8,40,12,60,20
753,Arizona,2004,14,3,5,0,0,8,30,7,9,1,0,17,60,25,90,27.8
754,Arkansas,2004,41,5,2,0,0,7,35,9,6,0,0,15,100,22,135,16.3
755,California,2004,6,11,0,0,0,11,40,20,5,0,0,25,80,36,120,30
756,Colorado,2004,3,9,1,0,0,10,35,14,10,0,0,24,65,34,100,34
757,Connecticut,2004,7,6,2,0,0,8,36,29,18,0,0,47,151,55,187,29.4
758,Deleware,2004,8,4,3,0,0,7,21,4,7,0,0,11,41,18,62,29
759,Florida,2004,20,5,5,0,0,10,40,15,15,0,0,30,120,40,160,25
760,Georgia,2004,25,11,2,0,0,13,56,28,10,0,0,38,180,51,236,21.6
761,Hawaii,2004,15,7,0,0,0,7,25,8,6,0,0,14,51,21,76,27.6
762,Idaho,2004,19,1,2,0,0,3,35,8,16,0,0,24,70,27,105,25.7
763,Illinois,2004,11,9,4,0,0,13,59,24,13,0,0,37,118,50,177,28.2
764,Indiana,2004,36,7,6,0,0,13,50,7,7,0,0,14,100,27,150,18
765,Iowa,2004,26,1,6,0,0,7,50,16,9,0,0,25,100,32,150,21.3
766,Kansas,2004,13,3,7,0,0,10,40,17,19,0,0,36,125,46,165,27.9
767,Kentucky,2004,48,0,4,0,0,4,38,9,2,0,0,11,100,15,138,10.9
768,Louisiana,2004,39,5,1,0,0,6,39,13,5,0,0,18,105,24,144,16.7
769,Maine,2004,18,9,4,0,0,13,35,26,11,0,0,37,151,50,186,26.9
770,Maryland,2004,2,12,3,0,0,15,47,38,11,0,0,49,141,64,188,34
771,Massachusetts,2004,20,10,1,0,0,11,40,33,6,0,0,39,160,50,200,25
772,Michigan,2004,23,5,6,0,0,11,38,15,9,0,0,24,110,35,148,23.6
773,Minnesota,2004,17,11,11,1,0,23,67,16,16,0,0,32,134,55,201,27.4
774,Mississippi,2004,47,4,0,0,0,4,52,13,5,0,0,18,122,22,174,12.6
775,Missouri,2004,27,4,3,0,0,7,34,24,11,0,0,35,163,42,197,21.3
776,Montana,2004,22,7,1,0,0,8,50,19,10,0,0,29,100,37,150,24.7
777,Nebraska*,2004,35,0,0,0,0,9,49,0,0,0,0,0,0,9,49,18.4
778,Nevada,2004,10,4,3,0,0,7,21,8,3,0,0,11,42,18,63,28.6
779,New Hampshire,2004,16,2,2,0,0,4,24,61,52,0,0,113,400,117,424,27.6
780,New Jersey,2004,43,4,2,0,0,6,40,10,3,0,0,13,80,19,120,15.8
781,New Mexico,2004,5,7,5,0,0,12,42,12,10,0,0,22,70,34,112,30.4
782,New York,2004,24,6,5,0,0,11,62,29,8,0,0,37,150,48,212,22.6
783,North Carolina,2004,29,5,2,0,0,7,50,18,11,0,0,29,120,36,170,21.2
784,North Dakota,2004,40,3,2,0,0,5,47,6,12,0,0,18,94,23,141,16.3
785,Ohio,2004,28,3,1,0,0,4,33,12,12,0,0,24,99,28,132,21.2
786,Oklahoma,2004,46,6,2,0,0,8,48,5,6,0,0,11,101,19,149,12.8
787,Oregon,2004,9,6,1,0,0,7,30,10,9,0,0,19,60,26,90,28.9
788,Pennsylvania,2004,45,5,3,0,0,8,50,10,18,0,0,28,203,36,253,14.2
789,Rhode Island,2004,31,7,2,0,0,9,38,11,3,0,0,14,75,23,113,20.4
790,South Carolina,2004,50,2,0,0,0,2,46,8,6,0,0,14,124,16,170,9.4
791,South Dakota,2004,42,0,4,0,0,4,35,4,9,0,0,13,70,17,105,16.2
792,Tennessee,2004,38,4,1,0,0,5,33,12,6,0,0,18,99,23,132,17.4
793,Texas,2004,33,2,2,0,0,4,31,11,20,0,0,31,150,35,181,19.3
794,Utah,2004,30,3,2,0,0,5,29,7,10,0,0,17,75,22,104,21.2
795,Vermont,2004,4,8,1,0,0,9,30,26,19,1,1,47,150,56,180,31.1
796,Virginia,2004,44,7,1,0,0,8,40,6,6,0,0,12,100,20,140,14.3
797,Washington,2004,1,16,5,0,0,21,49,20,11,0,0,31,98,52,147,35.4
798,West Virginia,2004,34,1,4,0,0,5,34,14,6,0,0,20,100,25,134,18.7
799,Wisconsin,2004,12,3,6,0,0,9,33,13,15,0,0,28,99,37,132,28
800,Wyoming,2004,37,4,2,0,0,6,30,6,4,0,0,10,60,16,90,17.8
801,Alabama,2003,49,2,1,0,0,3,35,9,2,0,0,11,105,14,140,10
802,Alaska,2003,30,3,0,1,0,4,20,3,5,0,0,8,40,12,60,20
803,Arizona,2003,13,3,5,0,0,8,30,8,9,0,0,17,60,25,90,27.8
804,Arkansas,2003,40,5,2,0,0,7,35,9,6,0,0,15,100,22,135,16.3
805,California,2003,6,11,0,0,0,11,40,20,5,0,0,25,80,36,120,30
806,Colorado,2003,2,8,1,0,0,9,35,14,10,0,0,24,65,33,100,33
807,Connecticut,2003,8,6,2,0,0,8,36,29,18,0,0,47,151,55,187,29.4
808,Deleware,2003,9,4,3,0,0,7,21,4,7,0,0,11,41,18,62,29
809,Florida,2003,22,5,5,0,0,10,40,15,14,0,0,29,120,39,160,24.4
810,Georgia,2003,26,11,2,0,0,13,56,30,8,0,0,38,180,51,236,21.6
811,Hawaii,2003,14,7,0,0,0,7,25,8,6,0,0,14,51,21,76,27.6
812,Idaho,2003,20,1,3,0,0,4,35,8,15,0,0,23,70,27,105,25.7
813,Illinois,2003,16,8,3,0,0,11,59,23,14,0,0,37,118,48,177,27.1
814,Indiana,2003,36,7,6,0,0,13,50,7,7,0,0,14,100,27,150,18
815,Iowa,2003,27,1,6,0,0,7,50,16,9,0,0,25,100,32,150,21.3
816,Kansas,2003,11,3,8,0,0,11,40,16,19,0,0,35,125,46,165,27.9
817,Kentucky,2003,48,0,4,0,0,4,38,9,2,0,0,11,100,15,138,10.9
818,Louisiana,2003,42,3,0,0,0,3,39,14,6,0,0,20,105,23,144,16
819,Maine,2003,17,9,4,0,0,13,35,26,11,0,0,37,151,50,186,26.9
820,Maryland,2003,3,12,3,0,0,15,47,37,10,0,0,47,141,62,188,33
821,Massachusetts,2003,19,11,1,0,0,12,40,34,6,0,0,40,160,52,200,26
822,Michigan,2003,23,5,6,0,0,11,38,15,9,0,0,24,110,35,148,23.6
823,Minnesota,2003,15,11,11,1,0,23,67,16,16,0,0,32,134,55,201,27.4
824,Mississippi,2003,46,6,0,0,0,6,52,12,4,0,0,16,122,22,174,12.6
825,Missouri,2003,28,4,3,0,0,7,34,24,11,0,0,35,163,42,197,21.3
826,Montana,2003,21,7,1,0,0,8,50,19,10,0,0,29,100,37,150,24.7
827,Nebraska*,2003,35,0,0,0,0,9,49,0,0,0,0,0,0,9,49,18.4
828,Nevada,2003,10,4,3,0,0,7,21,8,3,0,0,11,42,18,63,28.6
829,New Hampshire,2003,14,2,2,0,0,4,24,61,52,0,0,113,400,117,424,27.6
830,New Jersey,2003,39,3,2,0,0,5,40,10,5,0,0,15,80,20,120,16.7
831,New Mexico,2003,7,7,5,0,0,12,42,11,10,0,0,21,70,33,112,29.5
832,New York,2003,25,6,5,0,0,11,62,27,8,0,0,35,150,46,212,21.7
833,North Carolina,2003,29,5,2,0,0,7,50,17,11,0,0,28,120,35,170,20.6
834,North Dakota,2003,44,3,2,0,0,5,47,6,11,0,0,17,94,22,141,15.6
835,Ohio,2003,33,2,0,0,0,2,33,12,11,0,0,23,99,25,132,18.9
836,Oklahoma,2003,47,4,2,0,0,6,48,6,5,0,0,11,101,17,149,11.4
837,Oregon,2003,4,6,2,0,0,8,30,11,9,0,0,20,60,28,90,31.1
838,Pennsylvania,2003,45,5,3,0,0,8,50,10,17,0,0,27,203,35,253,13.8
839,Rhode Island,2003,32,7,2,0,0,9,38,10,3,0,0,13,75,22,113,19.5
840,South Carolina,2003,50,2,0,0,0,2,46,7,7,0,0,14,124,16,170,9.4
841,South Dakota,2003,41,0,4,0,0,4,35,4,9,0,0,13,70,17,105,16.2
842,Tennessee,2003,38,4,1,0,0,5,33,12,6,0,0,18,99,23,132,17.4
843,Texas,2003,32,2,2,0,0,4,31,11,20,0,0,31,150,35,181,19.3
844,Utah,2003,24,3,2,0,0,5,29,7,11,0,0,18,75,23,104,22.1
845,Vermont,2003,5,8,1,0,0,9,30,26,19,0,1,46,150,55,180,30.6
846,Virginia,2003,43,7,0,0,0,7,40,7,8,0,0,15,100,22,140,15.7
847,Washington,2003,1,15,6,0,0,21,49,21,12,0,0,33,98,54,147,36.7
848,West Virginia,2003,34,1,4,0,0,5,34,14,6,0,0,20,100,25,134,18.7
849,Wisconsin,2003,16,3,6,0,0,9,33,12,15,0,0,27,99,36,132,27.3
850,Wyoming,2003,37,3,2,0,0,5,30,6,5,0,0,11,60,16,90,17.8
851,Alabama,2002,50,2,1,0,0,3,35,6,2,0,0,8,105,11,140,7.9
852,Alaska,2002,32,2,0,1,0,3,20,4,5,0,0,9,40,12,60,20
853,Arizona,2002,2,6,5,0,0,11,30,10,11,0,0,21,60,32,90,35.6
854,Arkansas,2002,45,2,2,0,0,4,35,10,4,0,0,14,100,18,135,13.3
855,California,2002,13,10,0,0,0,10,40,20,4,0,0,24,80,34,120,28.3
856,Colorado,2002,4,7,3,0,0,10,35,13,11,0,0,24,65,34,100,34
857,Connecticut,2002,9,6,2,0,0,8,36,33,15,0,0,48,151,56,187,29.9
858,Deleware,2002,17,3,3,0,0,6,21,3,7,0,0,10,41,16,62,25.8
859,Florida,2002,21,3,4,0,0,7,40,17,14,0,0,31,120,38,160,23.8
860,Georgia,2002,30,9,1,0,0,10,56,29,10,0,0,39,180,49,236,20.8
861,Hawaii,2002,19,6,0,0,0,6,25,7,6,0,0,13,51,19,76,25
862,Idaho,2002,15,1,5,0,0,6,35,4,18,0,0,22,70,28,105,26.7
863,Illinois,2002,16,6,6,0,0,12,59,20,15,0,0,35,118,47,177,26.6
864,Indiana,2002,36,6,6,0,0,12,50,7,7,0,0,14,100,26,150,17.3
865,Iowa,2002,27,3,8,0,0,11,50,12,10,0,0,22,100,33,150,22
866,Kansas,2002,6,3,10,0,0,13,40,19,22,0,0,41,125,54,165,32.7
867,Kentucky,2002,47,0,4,0,0,4,38,9,2,0,0,11,100,15,138,10.9
868,Louisiana,2002,38,3,0,0,0,3,39,14,6,0,0,20,105,23,144,16
869,Maine,2002,8,11,3,1,0,15,35,28,13,0,0,41,151,56,186,30.1
870,Maryland,2002,11,7,2,0,0,9,47,37,9,0,0,46,141,55,188,29.3
871,Massachusetts,2002,18,11,1,0,0,12,40,32,7,0,0,39,160,51,200,25.5
872,Michigan,2002,26,3,3,0,0,6,38,15,12,0,0,27,110,33,148,22.3
873,Minnesota,2002,10,14,11,0,0,25,67,22,13,0,0,35,134,60,201,29.9
874,Mississippi,2002,46,6,0,0,0,6,52,12,4,0,0,16,122,22,174,12.6
875,Missouri,2002,24,2,4,0,0,6,34,24,15,0,0,39,163,45,197,22.8
876,Montana,2002,20,7,1,0,0,8,50,15,13,0,0,28,100,36,150,24
877,Nebraska*,2002,31,0,0,0,0,10,49,0,0,0,0,0,0,10,49,20.4
878,Nevada,2002,3,4,1,0,0,5,21,11,6,0,0,17,42,22,63,34.9
879,New Hampshire,2002,12,5,2,0,0,7,24,69,48,0,0,117,400,124,424,29.2
880,New Jersey,2002,40,3,2,0,0,5,40,10,4,0,0,14,80,19,120,15.8
881,New Mexico,2002,7,7,5,0,0,12,42,12,10,0,0,22,70,34,112,30.4
882,New York,2002,29,7,3,0,0,10,61,26,9,0,0,35,150,45,211,21.3
883,North Carolina,2002,33,4,1,0,0,5,50,14,13,0,0,27,120,32,170,18.8
884,North Dakota,2002,37,3,3,0,0,6,49,7,12,0,0,19,98,25,147,17
885,Ohio,2002,28,3,1,0,0,4,33,13,12,0,0,25,99,29,132,22
886,Oklahoma,2002,49,3,3,0,0,6,48,4,5,0,0,9,101,15,149,10.1
887,Oregon,2002,5,7,1,0,0,8,30,12,10,0,0,22,60,30,90,33.3
888,Pennsylvania,2002,44,5,3,0,0,8,50,12,15,0,0,27,203,35,253,13.8
889,Rhode Island,2002,25,8,2,0,0,10,50,20,4,0,0,24,100,34,150,22.7
890,South Carolina,2002,48,2,0,0,0,2,46,7,9,0,0,16,124,18,170,10.6
891,South Dakota,2002,42,0,5,0,0,5,35,4,7,0,0,11,70,16,105,15.2
892,Tennessee,2002,39,4,1,0,0,5,33,11,5,0,0,16,99,21,132,15.9
893,Texas,2002,34,2,2,0,0,4,31,16,14,0,0,30,150,34,181,18.8
894,Utah,2002,23,4,2,0,0,6,29,9,9,0,0,18,75,24,104,23.1
895,Vermont,2002,14,8,1,0,0,9,30,25,15,0,1,41,150,50,180,27.8
896,Virginia,2002,43,7,0,0,0,7,40,7,7,0,0,14,100,21,140,15
897,Washington,2002,1,17,6,0,0,23,49,21,13,0,0,34,98,57,147,38.8
898,West Virginia,2002,35,2,3,0,0,5,34,17,3,0,0,20,100,25,134,18.7
899,Wisconsin,2002,22,3,7,0,0,10,33,10,11,0,0,21,99,31,132,23.5
900,Wyoming,2002,41,3,2,0,0,5,30,4,5,0,0,9,60,14,90,15.6
901,Alabama,2001,50,2,1,0,0,3,35,6,2,0,0,8,105,11,140,7.9
902,Alaska,2001,30,2,0,2,0,4,20,4,5,0,0,9,40,13,60,21.7
903,Arizona,2001,2,6,4,0,0,10,30,10,12,0,0,22,60,32,90,35.6
904,Arkansas,2001,45,2,2,0,0,4,35,10,4,0,0,14,100,18,135,13.3
905,California,2001,13,10,0,0,0,10,40,20,4,0,0,24,80,34,120,28.3
906,Colorado,2001,4,7,3,0,0,10,35,13,11,0,0,24,65,34,100,34
907,Connecticut,2001,9,6,2,0,0,8,36,33,15,0,0,48,151,56,187,29.9
908,Deleware,2001,16,3,3,0,0,6,21,3,7,0,0,10,41,16,62,25.8
909,Florida,2001,21,3,4,0,0,7,40,17,14,0,0,31,120,38,160,23.8
910,Georgia,2001,31,9,1,0,0,10,56,28,11,0,0,39,180,49,236,20.8
911,Hawaii,2001,17,6,0,0,0,6,25,7,6,0,0,13,51,19,76,25
912,Idaho,2001,18,1,5,0,0,6,35,4,16,0,0,20,70,26,105,24.8
913,Illinois,2001,15,6,6,0,0,12,59,20,15,0,0,35,118,47,177,26.6
914,Indiana,2001,36,6,6,0,0,12,50,7,7,0,0,14,100,26,150,17.3
915,Iowa,2001,27,3,8,0,0,11,50,12,10,0,0,22,100,33,150,22
916,Kansas,2001,6,3,10,0,0,13,40,19,22,0,0,41,125,54,165,32.7
917,Kentucky,2001,47,0,4,0,0,4,38,9,2,0,0,11,100,15,138,10.9
918,Louisiana,2001,39,3,0,0,0,3,39,14,6,0,0,20,105,23,144,16
919,Maine,2001,8,11,3,1,0,15,35,28,13,1,0,42,151,57,186,30.6
920,Maryland,2001,10,7,2,0,0,9,47,37,9,0,0,46,141,55,188,29.3
921,Massachusetts,2001,19,11,1,0,0,12,40,30,7,0,0,37,160,49,200,24.5
922,Michigan,2001,25,3,3,0,0,6,38,15,12,0,0,27,110,33,148,22.3
923,Minnesota,2001,12,12,11,0,0,23,67,22,13,0,0,35,134,58,201,28.9
924,Mississippi,2001,46,6,0,0,0,6,52,12,4,0,0,16,122,22,174,12.6
925,Missouri,2001,22,2,4,0,0,6,34,25,15,0,0,40,163,46,197,23.4
926,Montana,2001,23,7,0,0,0,7,50,15,12,0,0,27,100,34,150,22.7
927,Nebraska*,2001,35,0,0,0,0,9,49,0,0,0,0,0,0,9,49,18.4
928,Nevada,2001,3,4,1,0,0,5,21,11,6,0,0,17,42,22,63,34.9
929,New Hampshire,2001,11,5,2,0,0,7,24,69,48,0,0,117,400,124,424,29.2
930,New Jersey,2001,43,1,2,0,0,3,40,10,5,0,0,15,80,18,120,15
931,New Mexico,2001,7,7,5,0,0,12,42,13,10,0,0,23,70,35,112,31.3
932,New York,2001,29,7,3,0,0,10,61,26,10,0,0,36,150,46,211,21.8
933,North Carolina,2001,32,4,1,0,0,5,50,14,13,0,0,27,120,32,170,18.8
934,North Dakota,2001,37,3,3,0,0,6,49,7,12,0,0,19,98,25,147,17
935,Ohio,2001,28,3,1,0,0,4,33,13,12,0,0,25,99,29,132,22
936,Oklahoma,2001,49,3,3,0,0,6,48,4,5,0,0,9,101,15,149,10.1
937,Oregon,2001,5,7,1,0,0,8,30,12,10,0,0,22,60,30,90,33.3
938,Pennsylvania,2001,44,4,3,0,0,7,50,12,15,0,0,27,203,34,253,13.4
939,Rhode Island,2001,23,8,2,0,0,10,50,20,4,0,0,24,100,34,150,22.7
940,South Carolina,2001,48,2,0,0,0,2,46,7,9,0,0,16,124,18,170,10.6
941,South Dakota,2001,42,0,5,0,0,5,35,4,7,0,0,11,70,16,105,15.2
942,Tennessee,2001,40,4,1,0,0,5,33,11,5,0,0,16,99,21,132,15.9
943,Texas,2001,33,2,2,0,0,4,31,16,14,0,0,30,150,34,181,18.8
944,Utah,2001,26,3,2,0,0,5,29,9,9,0,0,18,75,23,104,22.1
945,Vermont,2001,14,8,1,0,0,9,30,25,15,0,1,41,150,50,180,27.8
946,Virginia,2001,38,8,0,0,0,8,40,7,8,0,0,15,100,23,140,16.4
947,Washington,2001,1,17,6,0,0,23,49,21,13,0,0,34,98,57,147,38.8
948,West Virginia,2001,34,2,3,0,0,5,34,17,3,0,0,20,100,25,134,18.7
949,Wisconsin,2001,20,3,7,0,0,10,33,10,12,0,0,22,99,32,132,24.2
950,Wyoming,2001,41,3,2,0,0,5,30,4,5,0,0,9,60,14,90,15.6
951,Alabama,2000,50,2,1,0,0,3,35,6,2,0,0,8,105,11,140,7.9
952,Alaska,2000,33,1,0,2,0,3,20,3,5,0,0,8,40,11,60,18.3
953,Arizona,2000,2,4,3,0,0,7,30,9,16,0,0,25,60,32,90,35.6
954,Arkansas,2000,43,0,2,0,0,2,35,15,4,0,0,19,100,21,135,15.6
955,California,2000,15,10,1,0,0,11,40,15,4,1,0,20,80,31,120,25.8
956,Colorado,2000,4,5,7,0,0,12,35,10,12,0,0,22,65,34,100,34
957,Connecticut,2000,9,5,4,0,0,9,36,33,14,0,0,47,151,56,187,29.9
958,Deleware,2000,22,3,3,0,0,6,21,2,7,0,0,9,41,15,62,24.2
959,Florida,2000,23,3,4,0,0,7,40,21,11,0,0,32,120,39,160,24.4
960,Georgia,2000,31,9,1,0,0,10,56,26,10,0,0,36,180,46,236,19.5
961,Hawaii,2000,25,5,0,0,0,5,25,7,5,0,0,12,51,17,76,22.4
962,Idaho,2000,17,2,4,0,0,6,35,6,15,0,0,21,70,27,105,25.7
963,Illinois,2000,16,6,6,0,0,12,59,18,14,0,0,32,118,44,177,24.9
964,Indiana,2000,35,7,6,0,0,13,50,7,7,0,0,14,100,27,150,18
965,Iowa,2000,29,4,7,0,0,11,50,9,11,0,0,20,100,31,150,20.7
966,Kansas,2000,5,4,10,0,0,14,40,17,23,0,0,40,125,54,165,32.7
967,Kentucky,2000,47,0,4,0,0,4,38,10,2,0,0,12,100,16,138,11.6
968,Louisiana,2000,39,3,0,0,0,3,39,14,6,0,0,20,105,23,144,16
969,Maine,2000,12,12,3,1,0,16,35,22,13,1,0,36,151,52,186,28
970,Maryland,2000,10,7,2,0,0,9,47,37,9,0,0,46,141,55,188,29.3
971,Massachusetts,2000,14,10,1,0,0,11,40,32,9,0,0,41,160,52,200,26
972,Michigan,2000,21,2,3,0,0,5,38,18,13,0,0,31,110,36,148,24.3
973,Minnesota,2000,11,14,8,0,0,22,67,20,15,0,0,35,134,57,201,28.4
974,Mississippi,2000,46,6,0,0,0,6,52,12,4,0,0,16,122,22,174,12.6
975,Missouri,2000,26,2,4,0,0,6,34,22,16,0,0,38,163,44,197,22.3
976,Montana,2000,17,8,0,0,0,8,50,18,11,0,0,29,100,37,150,24.7
977,Nebraska*,2000,20,0,0,0,0,12,49,0,0,0,0,0,0,12,49,24.5
978,Nevada,2000,3,4,1,0,0,5,21,11,6,0,0,17,42,22,63,34.9
979,New Hampshire,2000,6,5,3,0,0,8,24,70,57,0,0,127,400,135,424,31.8
980,New Jersey,2000,42,1,2,0,0,3,40,10,6,0,0,16,80,19,120,15.8
981,New Mexico,2000,13,7,3,0,0,10,42,10,11,0,0,21,70,31,112,27.7
982,New York,2000,27,6,3,0,0,9,61,26,10,0,0,36,150,45,211,21.3
983,North Carolina,2000,34,5,2,0,0,7,50,12,12,0,0,24,120,31,170,18.2
984,North Dakota,2000,37,3,3,0,0,6,49,10,10,0,0,20,98,26,147,17.7
985,Ohio,2000,30,3,2,0,0,5,33,10,12,0,0,22,99,27,132,20.5
986,Oklahoma,2000,49,4,2,0,0,6,48,5,4,0,0,9,101,15,149,10.1
987,Oregon,2000,8,6,2,0,0,8,30,11,8,0,0,19,60,27,90,30
988,Pennsylvania,2000,45,4,3,0,0,7,50,12,13,0,0,25,203,32,253,12.6
989,Rhode Island,2000,19,9,2,0,0,11,50,22,4,0,0,26,100,37,150,24.7
990,South Carolina,2000,48,2,0,0,0,2,46,7,9,0,0,16,124,18,170,10.6
991,South Dakota,2000,44,1,4,0,0,5,35,4,6,0,0,10,70,15,105,14.3
992,Tennessee,2000,39,5,1,0,0,6,33,12,5,0,0,17,99,23,132,17.4
993,Texas,2000,38,2,2,0,0,4,31,16,13,0,0,29,150,33,181,18.2
994,Utah,2000,28,3,1,0,0,4,29,8,10,0,0,18,75,22,104,21.2
995,Vermont,2000,7,9,1,0,0,10,30,34,13,0,0,47,150,57,180,31.7
996,Virginia,2000,41,8,0,0,0,8,40,7,8,0,0,15,100,23,140,16.4
997,Washington,2000,1,18,5,0,0,23,49,22,15,0,0,37,98,60,147,40.8
998,West Virginia,2000,36,2,2,0,0,4,34,14,6,0,0,20,100,24,134,17.9
999,Wisconsin,2000,24,4,7,0,0,11,33,10,10,0,0,20,99,31,132,23.5
1000,Wyoming,2000,32,3,2,0,0,5,30,7,5,0,0,12,60,17,90,18.9
1001,Alabama,1999,50,2,1,0,0,3,35,6,2,0,0,8,105,11,140,7.9
1002,Alaska,1999,33,1,0,2,0,3,20,3,5,0,0,8,40,11,60,18.3
1003,Arizona,1999,3,4,3,0,0,7,30,9,16,0,0,25,60,32,90,35.6
1004,Arkansas,1999,42,0,0,0,0,0,35,16,4,0,0,20,100,20,135,14.8
1005,California,1999,15,9,1,0,0,10,40,16,4,1,0,21,80,31,120,25.8
1006,Colorado,1999,4,5,7,0,0,12,35,10,12,0,0,22,65,34,100,34
1007,Connecticut,1999,9,5,4,0,0,9,36,33,13,0,0,46,151,55,187,29.4
1008,Deleware,1999,22,3,3,0,0,6,21,2,7,0,0,9,41,15,62,24.2
1009,Florida,1999,23,3,4,0,0,7,40,20,11,0,0,31,120,38,160,23.8
1010,Georgia,1999,32,8,1,0,0,9,56,24,11,0,0,35,180,44,236,18.6
1011,Hawaii,1999,25,5,0,0,0,5,25,7,5,0,0,12,51,17,76,22.4
1012,Idaho,1999,18,2,4,0,0,6,35,5,15,0,0,20,70,26,105,24.8
1013,Illinois,1999,16,5,7,0,0,12,59,19,14,0,0,33,118,45,177,25.4
1014,Indiana,1999,35,7,6,0,0,13,50,7,7,0,0,14,100,27,150,18
1015,Iowa,1999,27,4,7,0,0,11,50,10,11,0,0,21,100,32,150,21.3
1016,Kansas,1999,5,4,10,0,0,14,40,17,24,0,0,41,125,55,165,33.3
1017,Kentucky,1999,47,0,4,0,0,4,38,10,2,0,0,12,100,16,138,11.6
1018,Louisiana,1999,43,2,0,0,0,2,39,14,4,0,0,18,105,20,144,13.9
1019,Maine,1999,12,12,3,1,0,16,35,22,13,1,0,36,151,52,186,28
1020,Maryland,1999,10,7,2,0,0,9,47,37,9,0,0,46,141,55,188,29.3
1021,Massachusetts,1999,14,9,1,0,0,10,40,33,9,0,0,42,160,52,200,26
1022,Michigan,1999,21,2,3,0,0,5,38,18,13,0,0,31,110,36,148,24.3
1023,Minnesota,1999,11,14,8,0,0,22,67,20,15,0,0,35,134,57,201,28.4
1024,Mississippi,1999,46,3,0,0,0,3,52,14,4,0,0,18,122,21,174,12.1
1025,Missouri,1999,26,1,4,0,0,5,34,22,16,0,0,38,163,43,197,21.8
1026,Montana,1999,19,8,0,0,0,8,50,18,11,0,0,29,100,37,150,24.7
1027,Nebraska*,1999,20,0,0,0,0,12,49,0,0,0,0,0,0,12,49,24.5
1028,Nevada,1999,2,4,1,0,0,5,21,12,6,0,0,18,42,23,63,36.5
1029,New Hampshire,1999,6,5,3,0,0,8,24,70,57,0,0,127,400,135,424,31.8
1030,New Jersey,1999,40,1,2,0,0,3,40,9,7,0,0,16,80,19,120,15.8
1031,New Mexico,1999,13,7,3,0,0,10,42,10,11,0,0,21,70,31,112,27.7
1032,New York,1999,30,5,3,0,0,8,61,26,10,0,0,36,150,44,211,20.9
1033,North Carolina,1999,34,5,2,0,0,7,50,12,12,0,0,24,120,31,170,18.2
1034,North Dakota,1999,37,3,3,0,0,6,49,10,10,0,0,20,98,26,147,17.7
1035,Ohio,1999,28,3,2,0,0,5,33,10,13,0,0,23,99,28,132,21.2
1036,Oklahoma,1999,49,4,2,0,0,6,48,5,4,0,0,9,101,15,149,10.1
1037,Oregon,1999,8,6,2,0,0,8,30,11,8,0,0,19,60,27,90,30
1038,Pennsylvania,1999,45,4,3,0,0,7,50,12,13,0,0,25,203,32,253,12.6
1039,Rhode Island,1999,17,9,2,0,0,11,50,22,5,0,0,27,100,38,150,25.3
1040,South Carolina,1999,48,2,1,0,0,3,46,6,10,0,0,16,124,19,170,11.2
1041,South Dakota,1999,44,1,4,0,0,5,35,4,5,0,0,9,70,14,105,13.3
1042,Tennessee,1999,39,4,1,0,0,5,33,12,5,0,0,17,99,22,132,16.7
1043,Texas,1999,38,2,2,0,0,4,31,16,12,0,0,28,150,32,181,17.7
1044,Utah,1999,29,3,1,0,0,4,29,8,10,0,0,18,75,22,104,21.2
1045,Vermont,1999,7,9,1,0,0,10,30,34,13,0,0,47,150,57,180,31.7
1046,Virginia,1999,41,6,1,0,0,7,40,8,7,0,0,15,100,22,140,15.7
1047,Washington,1999,1,18,5,0,0,23,49,22,15,0,0,37,98,60,147,40.8
1048,West Virginia,1999,36,2,2,0,0,4,34,14,6,0,0,20,100,24,134,17.9
1049,Wisconsin,1999,24,4,7,0,0,11,33,10,10,0,0,20,99,31,132,23.5
1050,Wyoming,1999,31,3,2,0,0,5,30,8,5,0,0,13,60,18,90,20
1051,Alabama,1998,50,2,0,0,0,2,35,4,0,0,0,4,105,6,140,4.3
1052,Alaska,1998,43,1,0,2,0,3,20,1,4,0,0,5,40,8,60,13.3
1053,Arizona,1998,2,4,4,0,0,8,30,8,17,0,0,25,60,33,90,36.7
1054,Arkansas,1998,35,0,1,0,0,1,35,20,2,0,0,22,100,23,135,17
1055,California,1998,24,5,1,0,0,6,40,17,3,0,0,20,80,26,120,21.7
1056,Colorado,1998,3,5,5,0,0,10,35,10,15,0,0,25,65,35,100,35
1057,Connecticut,1998,10,5,4,0,0,9,36,32,13,0,0,45,151,54,187,28.9
1058,Deleware,1998,14,3,4,0,0,7,21,2,7,0,0,9,41,16,62,25.8
1059,Florida,1998,19,2,4,0,0,6,40,23,9,0,0,32,120,38,160,23.8
1060,Georgia,1998,37,6,1,0,0,7,56,22,10,0,0,32,180,39,236,16.5
1061,Hawaii,1998,33,5,0,0,0,5,25,5,3,0,0,8,51,13,76,17.1
1062,Idaho,1998,18,2,4,0,0,6,35,4,15,0,0,19,70,25,105,23.8
1063,Illinois,1998,16,4,6,0,0,10,59,18,17,0,0,35,118,45,177,25.4
1064,Indiana,1998,29,7,7,0,0,14,50,6,8,0,0,14,100,28,150,18.7
1065,Iowa,1998,26,5,7,0,0,12,50,10,10,0,0,20,100,32,150,21.3
1066,Kansas,1998,9,4,10,0,0,14,40,15,20,0,0,35,125,49,165,29.7
1067,Kentucky,1998,49,0,2,0,0,2,38,7,4,0,0,11,100,13,138,9.4
1068,Louisiana,1998,46,2,0,0,0,2,39,12,2,1,0,15,105,17,144,11.8
1069,Maine,1998,14,9,3,1,0,13,35,23,11,1,0,35,151,48,186,25.8
1070,Maryland,1998,8,7,1,0,0,8,47,37,11,0,0,48,141,56,188,29.8
1071,Massachusetts,1998,20,7,0,0,0,7,40,30,10,0,0,40,160,47,200,23.5
1072,Michigan,1998,23,2,1,0,0,3,38,17,14,0,0,31,110,34,148,23
1073,Minnesota,1998,6,14,8,0,0,22,67,26,14,0,0,40,134,62,201,30.8
1074,Mississippi,1998,44,3,0,0,0,3,52,15,4,0,0,19,122,22,174,12.6
1075,Missouri,1998,27,0,3,0,0,3,34,21,18,0,0,39,163,42,197,21.3
1076,Montana,1998,21,8,1,0,0,9,50,15,11,0,0,26,100,35,150,23.3
1077,Nebraska*,1998,12,0,0,0,0,13,49,0,0,0,0,0,0,13,49,26.5
1078,Nevada,1998,4,3,2,0,0,5,21,10,6,0,0,16,42,21,63,33.3
1079,New Hampshire,1998,7,5,3,0,0,8,24,64,57,1,0,122,400,130,424,30.7
1080,New Jersey,1998,39,2,2,0,0,4,40,9,7,0,0,16,80,20,120,16.7
1081,New Mexico,1998,11,7,3,0,0,10,42,10,10,0,0,20,70,30,112,26.8
1082,New York,1998,28,7,1,0,0,8,61,25,10,0,0,35,150,43,211,20.4
1083,North Carolina,1998,32,4,2,0,0,6,50,11,13,0,0,24,120,30,170,17.6
1084,North Dakota,1998,39,2,4,0,0,6,49,7,11,0,0,18,98,24,147,16.3
1085,Ohio,1998,25,3,5,0,0,8,33,7,14,0,0,21,99,29,132,22
1086,Oklahoma,1998,48,4,2,0,0,6,48,6,3,0,0,9,101,15,149,10.1
1087,Oregon,1998,17,5,4,0,0,9,30,8,6,0,0,14,60,23,90,25.6
1088,Pennsylvania,1998,46,3,3,0,0,6,50,12,13,0,0,25,203,31,253,12.3
1089,Rhode Island,1998,13,8,3,0,0,11,50,22,6,0,0,28,100,39,150,26
1090,South Carolina,1998,44,2,1,0,0,3,46,8,11,0,0,19,124,22,170,12.9
1091,South Dakota,1998,32,2,3,0,0,5,35,5,8,0,0,13,70,18,105,17.1
1092,Tennessee,1998,42,3,0,0,0,3,33,12,3,0,0,15,99,18,132,13.6
1093,Texas,1998,30,1,2,0,0,3,31,19,11,0,0,30,150,33,181,18.2
1094,Utah,1998,38,1,0,0,0,1,29,6,10,0,0,16,75,17,104,16.3
1095,Vermont,1998,4,10,2,0,0,12,30,34,14,0,0,48,150,60,180,33.3
1096,Virginia,1998,40,6,1,0,0,7,40,8,6,0,0,14,100,21,140,15
1097,Washington,1998,1,16,7,0,0,23,49,20,15,0,0,35,98,58,147,39.5
1098,West Virginia,1998,41,2,2,0,0,4,34,11,5,0,0,16,100,20,134,14.9
1099,Wisconsin,1998,20,3,7,0,0,10,33,13,8,0,0,21,99,31,132,23.5
1100,Wyoming,1998,31,2,2,0,0,4,30,6,6,0,0,12,60,16,90,17.8
1101,Alabama,1997,50,2,0,0,0,2,35,4,0,0,0,4,105,6,140,4.3
1102,Alaska,1997,43,1,0,2,0,3,20,1,4,0,0,5,40,8,60,13.3
1103,Arizona,1997,2,4,4,0,0,8,30,9,17,0,0,26,60,34,90,37.8
1104,Arkansas,1997,35,0,1,0,0,1,35,20,2,0,0,22,100,23,135,17
1105,California,1997,24,6,1,0,0,7,40,17,3,0,0,20,80,27,120,22.5
1106,Colorado,1997,3,5,5,0,0,10,35,10,15,0,0,25,65,35,100,35
1107,Connecticut,1997,10,5,4,0,0,9,36,32,13,0,0,45,151,54,187,28.9
1108,Deleware,1997,15,3,4,0,0,7,21,2,7,0,0,9,41,16,62,25.8
1109,Florida,1997,19,2,4,0,0,6,40,23,9,0,0,32,120,38,160,23.8
1110,Georgia,1997,36,6,1,0,0,7,56,22,10,0,0,32,180,39,236,16.5
1111,Hawaii,1997,33,5,0,0,0,5,25,5,3,0,0,8,51,13,76,17.1
1112,Idaho,1997,18,2,4,0,0,6,35,4,15,0,0,19,70,25,105,23.8
1113,Illinois,1997,14,5,6,0,0,11,59,18,17,0,0,35,118,46,177,26
1114,Indiana,1997,28,7,7,0,0,14,50,6,8,0,0,14,100,28,150,18.7
1115,Iowa,1997,26,5,7,0,0,12,50,10,10,0,0,20,100,32,150,21.3
1116,Kansas,1997,9,4,10,0,0,14,40,15,20,0,0,35,125,49,165,29.7
1117,Kentucky,1997,49,0,2,0,0,2,38,7,4,0,0,11,100,13,138,9.4
1118,Louisiana,1997,47,2,0,0,0,2,39,12,2,1,0,15,105,17,144,11.8
1119,Maine,1997,15,9,3,1,0,13,35,23,11,1,0,35,151,48,186,25.8
1120,Maryland,1997,8,7,1,0,0,8,47,37,11,0,0,48,141,56,188,29.8
1121,Massachusetts,1997,22,7,0,0,0,7,40,29,10,0,0,39,160,46,200,23
1122,Michigan,1997,23,2,1,0,0,3,38,17,14,0,0,31,110,34,148,23
1123,Minnesota,1997,6,14,8,0,0,22,67,26,14,0,0,40,134,62,201,30.8
1124,Mississippi,1997,45,3,0,0,0,3,52,15,4,0,0,19,122,22,174,12.6
1125,Missouri,1997,27,0,3,0,0,3,34,21,18,0,0,39,163,42,197,21.3
1126,Montana,1997,21,8,1,0,0,9,50,15,11,0,0,26,100,35,150,23.3
1127,Nebraska*,1997,12,0,0,0,0,13,49,0,0,0,0,0,0,13,49,26.5
1128,Nevada,1997,4,3,2,0,0,5,21,10,6,0,0,16,42,21,63,33.3
1129,New Hampshire,1997,7,5,3,0,0,8,24,64,57,1,0,122,400,130,424,30.7
1130,New Jersey,1997,39,1,1,0,0,2,40,8,9,0,0,17,80,19,120,15.8
1131,New Mexico,1997,11,7,3,0,0,10,42,10,10,0,0,20,70,30,112,26.8
1132,New York,1997,29,7,1,0,0,8,61,22,9,0,0,31,150,39,211,18.5
1133,North Carolina,1997,34,4,2,0,0,6,50,10,13,0,0,23,120,29,170,17.1
1134,North Dakota,1997,38,2,4,0,0,6,49,7,11,0,0,18,98,24,147,16.3
1135,Ohio,1997,25,3,5,0,0,8,33,7,14,0,0,21,99,29,132,22
1136,Oklahoma,1997,48,4,2,0,0,6,48,6,3,0,0,9,101,15,149,10.1
1137,Oregon,1997,17,5,4,0,0,9,30,8,6,0,0,14,60,23,90,25.6
1138,Pennsylvania,1997,46,3,3,0,0,6,50,12,13,0,0,25,203,31,253,12.3
1139,Rhode Island,1997,13,8,3,0,0,11,50,22,6,0,0,28,100,39,150,26
1140,South Carolina,1997,44,2,1,0,0,3,46,8,11,0,0,19,124,22,170,12.9
1141,South Dakota,1997,32,2,3,0,0,5,35,5,8,0,0,13,70,18,105,17.1
1142,Tennessee,1997,42,3,0,0,0,3,33,12,3,0,0,15,99,18,132,13.6
1143,Texas,1997,30,1,2,0,0,3,31,19,11,0,0,30,150,33,181,18.2
1144,Utah,1997,37,1,0,0,0,1,29,6,10,0,0,16,75,17,104,16.3
1145,Vermont,1997,4,10,2,0,0,12,30,34,14,0,0,48,150,60,180,33.3
1146,Virginia,1997,40,6,1,0,0,7,40,10,4,0,0,14,100,21,140,15
1147,Washington,1997,1,16,7,0,0,23,49,20,15,0,0,35,98,58,147,39.5
1148,West Virginia,1997,41,2,2,0,0,4,34,11,5,0,0,16,100,20,134,14.9
1149,Wisconsin,1997,20,3,6,0,0,9,33,13,9,0,0,22,99,31,132,23.5
1150,Wyoming,1997,31,2,2,0,0,4,30,6,6,0,0,12,60,16,90,17.8
1151,Alabama,1996,50,1,0,0,0,1,35,4,0,0,0,4,105,5,140,3.6
1152,Alaska,1996,21,2,0,2,0,4,20,4,5,1,0,10,40,14,60,23.3
1153,Arizona,1996,4,3,5,0,0,8,30,7,12,0,0,19,60,27,90,30
1154,Arkansas,1996,43,0,1,0,0,1,35,14,2,0,0,16,100,17,135,12.6
1155,California,1996,26,3,1,1,0,5,40,16,3,0,0,19,80,24,120,20
1156,Colorado,1996,3,5,5,0,0,10,35,10,11,0,0,21,65,31,100,31
1157,Connecticut,1996,11,4,4,0,0,8,36,30,12,0,0,42,151,50,187,26.7
1158,Deleware,1996,25,2,4,0,0,6,21,0,7,0,0,7,41,13,62,21
1159,Florida,1996,30,3,3,0,0,6,40,20,5,0,0,25,120,31,160,19.4
1160,Georgia,1996,32,6,2,0,0,8,56,23,12,0,0,35,180,43,236,18.2
1161,Hawaii,1996,29,5,0,0,0,5,25,6,4,0,0,10,51,15,76,19.7
1162,Idaho,1996,10,4,3,0,0,7,35,5,17,0,0,22,70,29,105,27.6
1163,Illinois,1996,21,5,5,0,0,10,59,15,16,0,0,31,118,41,177,23.2
1164,Indiana,1996,23,7,7,0,0,14,50,6,13,0,0,19,100,33,150,22
1165,Iowa,1996,35,4,6,0,0,10,50,7,10,0,0,17,100,27,150,18
1166,Kansas,1996,10,3,11,0,0,14,40,12,20,0,0,32,125,46,165,27.9
1167,Kentucky,1996,49,0,2,0,0,2,38,5,4,0,0,9,100,11,138,8
1168,Louisiana,1996,47,2,0,0,0,2,39,11,2,1,0,14,105,16,144,11.1
1169,Maine,1996,12,7,3,1,0,11,35,23,15,0,0,38,151,49,186,26.3
1170,Maryland,1996,8,6,1,0,0,7,47,36,11,0,0,47,141,54,188,28.7
1171,Massachusetts,1996,17,6,2,0,0,8,40,27,13,0,0,40,160,48,200,24
1172,Michigan,1996,22,2,1,0,0,3,38,17,13,0,0,30,110,33,148,22.3
1173,Minnesota,1996,13,11,7,0,0,18,67,19,13,0,0,32,134,50,201,24.9
1174,Mississippi,1996,46,3,0,0,0,3,52,14,3,0,0,17,122,20,174,11.5
1175,Missouri,1996,28,0,3,0,0,3,34,18,18,0,0,36,163,39,197,19.8
1176,Montana,1996,17,7,2,0,0,9,50,11,16,0,0,27,100,36,150,24
1177,Nebraska*,1996,14,0,0,0,0,12,49,0,0,0,0,0,0,12,49,24.5
1178,Nevada,1996,2,2,3,0,0,5,21,9,8,0,0,17,42,22,63,34.9
1179,New Hampshire,1996,6,3,3,0,0,6,24,45,75,0,0,120,400,126,424,29.7
1180,New Jersey,1996,37,1,0,0,0,1,40,7,10,0,0,17,80,18,120,15
1181,New Mexico,1996,27,6,2,0,0,8,42,9,6,0,0,15,70,23,112,20.5
1182,New York,1996,34,8,1,0,0,9,61,21,8,0,0,29,150,38,211,18
1183,North Carolina,1996,36,3,3,0,0,6,50,7,15,0,0,22,120,28,170,16.5
1184,North Dakota,1996,37,5,4,0,0,9,49,4,9,0,0,13,98,22,147,15
1185,Ohio,1996,15,3,5,0,0,8,33,10,13,1,0,24,99,32,132,24.2
1186,Oklahoma,1996,48,5,2,0,0,7,48,6,3,0,0,9,101,16,149,10.7
1187,Oregon,1996,7,4,3,0,0,7,30,11,8,0,0,19,60,26,90,28.9
1188,Pennsylvania,1996,45,3,1,0,0,4,50,12,14,0,0,26,203,30,253,11.9
1189,Rhode Island,1996,17,8,2,0,0,10,50,20,6,0,0,26,100,36,150,24
1190,South Carolina,1996,44,2,1,0,0,3,46,8,10,0,0,18,124,21,170,12.4
1191,South Dakota,1996,33,4,1,0,0,5,35,4,10,0,0,14,70,19,105,18.1
1192,Tennessee,1996,42,2,1,0,0,3,33,11,4,0,0,15,99,18,132,13.6
1193,Texas,1996,31,2,2,0,0,4,31,18,11,0,0,29,150,33,181,18.2
1194,Utah,1996,41,1,0,0,0,1,29,4,10,0,0,14,75,15,104,14.4
1195,Vermont,1996,4,5,6,0,0,11,30,29,14,0,0,43,150,54,180,30
1196,Virginia,1996,37,6,1,0,0,7,40,10,4,0,0,14,100,21,140,15
1197,Washington,1996,1,14,6,0,0,20,49,20,18,0,0,38,98,58,147,39.5
1198,West Virginia,1996,38,3,2,0,0,5,34,10,5,0,0,15,100,20,134,14.9
1199,Wisconsin,1996,15,2,6,0,0,8,33,15,9,0,0,24,99,32,132,24.2
1200,Wyoming,1996,24,0,1,0,0,1,30,7,11,0,0,18,60,19,90,21.1
1201,Alabama,1995,50,1,0,0,0,1,35,4,0,0,0,4,105,5,140,3.6
1202,Alaska,1995,21,2,0,2,0,4,20,4,5,1,0,10,40,14,60,23.3
1203,Arizona,1995,4,3,5,0,0,8,30,7,12,0,0,19,60,27,90,30
1204,Arkansas,1995,42,0,1,0,0,1,35,14,2,0,0,16,100,17,135,12.6
1205,California,1995,26,3,1,1,0,5,40,16,4,0,0,20,80,25,120,20.8
1206,Colorado,1995,3,5,5,0,0,10,35,10,11,0,0,21,65,31,100,31
1207,Connecticut,1995,11,4,4,0,0,8,36,30,12,0,0,42,151,50,187,26.7
1208,Deleware,1995,25,2,4,0,0,6,21,0,7,0,0,7,41,13,62,21
1209,Florida,1995,30,3,3,0,0,6,40,20,5,0,0,25,120,31,160,19.4
1210,Georgia,1995,32,6,2,0,0,8,56,23,12,0,0,35,180,43,236,18.2
1211,Hawaii,1995,29,5,0,0,0,5,25,6,4,0,0,10,51,15,76,19.7
1212,Idaho,1995,10,4,3,0,0,7,35,5,17,0,0,22,70,29,105,27.6
1213,Illinois,1995,21,5,5,0,0,10,59,15,16,0,0,31,118,41,177,23.2
1214,Indiana,1995,23,7,7,0,0,14,50,6,13,0,0,19,100,33,150,22
1215,Iowa,1995,35,4,6,0,0,10,50,7,10,0,0,17,100,27,150,18
1216,Kansas,1995,10,3,11,0,0,14,40,12,20,0,0,32,125,46,165,27.9
1217,Kentucky,1995,49,0,2,0,0,2,38,5,4,0,0,9,100,11,138,8
1218,Louisiana,1995,48,2,0,0,0,2,39,10,2,0,0,12,105,14,144,9.7
1219,Maine,1995,12,7,3,1,0,11,35,22,15,0,0,37,151,48,186,25.8
1220,Maryland,1995,8,6,1,0,0,7,47,36,11,0,0,47,141,54,188,28.7
1221,Massachusetts,1995,17,6,2,0,0,8,40,27,13,0,0,40,160,48,200,24
1222,Michigan,1995,22,2,1,0,0,3,38,17,13,0,0,30,110,33,148,22.3
1223,Minnesota,1995,13,11,7,0,0,18,67,19,13,0,0,32,134,50,201,24.9
1224,Mississippi,1995,45,3,1,0,0,4,52,14,2,0,0,16,122,20,174,11.5
1225,Missouri,1995,28,0,3,0,0,3,34,18,18,0,0,36,163,39,197,19.8
1226,Montana,1995,17,7,2,0,0,9,50,11,16,0,0,27,100,36,150,24
1227,Nebraska*,1995,14,0,0,0,0,12,49,0,0,0,0,0,0,12,49,24.5
1228,Nevada,1995,2,2,3,0,0,5,21,9,8,0,0,17,42,22,63,34.9
1229,New Hampshire,1995,6,3,3,0,0,6,24,45,75,0,0,120,400,126,424,29.7
1230,New Jersey,1995,41,1,0,0,0,1,40,6,9,0,0,15,80,16,120,13.3
1231,New Mexico,1995,27,6,2,0,0,8,42,9,6,0,0,15,170,23,112,20.5
1232,New York,1995,34,8,1,0,0,9,61,21,8,0,0,29,150,38,211,18
1233,North Carolina,1995,36,3,3,0,0,6,50,7,15,0,0,22,120,28,170,16.5
1234,North Dakota,1995,37,5,4,0,0,9,49,4,9,0,0,13,98,22,147,15
1235,Ohio,1995,15,3,5,0,0,8,33,10,13,1,0,24,99,32,132,24.2
1236,Oklahoma,1995,47,5,2,0,0,7,48,6,3,0,0,9,101,16,149,10.7
1237,Oregon,1995,7,4,3,0,0,7,30,11,8,0,0,19,60,26,90,28.9
1238,Pennsylvania,1995,44,3,1,0,0,4,50,12,14,0,0,26,203,30,253,11.9
1239,Rhode Island,1995,17,8,2,0,0,10,50,20,6,0,0,26,100,36,150,24
1240,South Carolina,1995,43,2,1,0,0,3,46,8,10,0,0,18,124,21,170,12.4
1241,South Dakota,1995,33,4,1,0,0,5,35,4,10,0,0,14,70,19,105,18.1
1242,Tennessee,1995,40,2,1,0,0,3,33,11,4,0,0,15,99,18,132,13.6
1243,Texas,1995,31,2,2,0,0,4,31,18,11,0,0,29,150,33,181,18.2
1244,Utah,1995,39,1,0,0,0,1,29,4,10,0,0,14,75,15,104,14.4
1245,Vermont,1995,4,5,6,0,0,11,30,29,14,0,0,43,150,54,180,30
1246,Virginia,1995,46,3,1,0,0,4,40,9,3,0,0,12,100,16,140,11.4
1247,Washington,1995,1,14,6,0,0,20,49,20,18,0,0,38,98,58,147,39.5
1248,West Virginia,1995,38,3,2,0,0,5,34,10,5,0,0,15,100,20,134,14.9
1249,Wisconsin,1995,15,2,6,0,0,8,33,15,9,0,0,24,99,32,132,24.2
1250,Wyoming,1995,24,0,1,0,0,1,30,7,11,0,0,18,60,19,90,21.1
1251,Alabama,1994,50,1,1,0,0,2,35,6,0,0,0,6,105,8,140,5.7
1252,Alaska,1994,23,3,0,1,0,4,20,5,4,0,0,9,40,13,60,21.7
1253,Arizona,1994,3,3,6,0,0,9,30,9,12,0,0,21,60,30,90,33.3
1254,Arkansas,1994,45,1,0,0,0,1,35,11,3,0,0,14,100,15,135,11.1
1255,California,1994,19,2,2,1,0,5,40,19,5,0,0,24,80,29,120,24.2
1256,Colorado,1994,2,4,5,0,0,9,35,15,11,0,0,26,65,35,100,35
1257,Connecticut,1994,11,4,4,0,0,8,36,29,12,0,0,41,151,49,187,26.2
1258,Deleware,1994,36,3,1,0,0,4,21,2,4,0,0,6,41,10,62,16.1
1259,Florida,1994,31,4,2,0,0,6,40,17,6,0,0,23,120,29,160,18.1
1260,Georgia,1994,33,4,2,0,0,6,56,23,12,0,0,35,180,41,236,17.4
1261,Hawaii,1994,14,7,1,0,0,8,25,9,2,0,0,11,51,19,76,25
1262,Idaho,1994,7,6,3,0,0,9,35,5,17,0,0,22,70,31,105,29.5
1263,Illinois,1994,20,6,6,0,0,12,59,15,14,0,0,29,118,41,177,23.2
1264,Indiana,1994,29,7,6,0,0,13,50,7,9,0,0,16,100,29,150,19.3
1265,Iowa,1994,38,4,3,0,0,7,50,8,8,0,0,16,100,23,150,15.3
1266,Kansas,1994,8,3,11,0,0,14,40,19,14,0,0,33,125,47,165,28.5
1267,Kentucky,1994,49,1,0,0,0,1,38,5,2,0,0,7,100,8,138,5.8
1268,Louisiana,1994,47,1,0,0,0,1,39,10,2,0,0,12,105,13,144,9
1269,Maine,1994,6,7,4,0,0,11,35,37,11,0,0,48,151,59,186,31.7
1270,Maryland,1994,16,10,0,0,0,10,47,31,5,0,0,36,141,46,188,24.5
1271,Massachusetts,1994,21,7,2,0,0,9,40,25,11,0,0,36,160,45,200,22.5
1272,Michigan,1994,25,2,1,0,0,3,38,16,12,0,0,28,110,31,148,20.9
1273,Minnesota,1994,10,12,8,0,0,20,67,24,10,0,0,34,134,54,201,26.9
1274,Mississippi,1994,43,3,1,0,0,4,52,14,2,0,0,16,122,20,174,11.5
1275,Missouri,1994,26,1,1,0,0,2,34,24,14,0,0,38,163,40,197,20.3
1276,Montana,1994,24,8,2,0,0,10,50,14,8,0,0,22,100,32,150,21.3
1277,Nebraska*,1994,22,0,0,0,0,11,49,0,0,0,0,0,0,11,49,22.4
1278,Nevada,1994,13,3,2,0,0,5,21,8,3,0,0,11,42,16,63,25.4
1279,New Hampshire,1994,5,6,3,0,0,9,24,58,74,0,0,132,400,141,424,33.3
1280,New Jersey,1994,42,1,0,0,0,1,40,4,9,0,0,13,80,14,120,11.7
1281,New Mexico,1994,28,6,2,0,0,8,42,9,5,0,0,14,70,22,112,19.6
1282,New York,1994,30,7,1,0,0,8,61,22,8,1,0,31,150,39,211,18.5
1283,North Carolina,1994,32,6,1,0,0,7,50,15,8,0,0,23,120,30,170,17.6
1284,North Dakota,1994,37,5,3,0,0,8,49,8,7,0,0,15,98,23,147,15.6
1285,Ohio,1994,18,2,5,0,0,7,33,15,10,0,0,25,99,32,132,24.2
1286,Oklahoma,1994,48,5,1,0,0,6,48,4,3,0,0,7,101,13,149,8.7
1287,Oregon,1994,12,6,1,0,0,7,30,10,6,0,0,16,60,23,90,25.6
1288,Pennsylvania,1994,46,3,1,0,0,4,50,14,10,0,0,24,203,28,253,11.1
1289,Rhode Island,1994,15,9,2,0,0,11,50,18,8,0,0,26,100,37,150,24.7
1290,South Carolina,1994,40,2,1,0,0,3,46,10,9,0,0,19,124,22,170,12.9
1291,South Dakota,1994,27,6,1,0,0,7,35,3,11,0,0,14,70,21,105,20
1292,Tennessee,1994,41,2,1,0,0,3,33,8,5,0,0,13,99,16,132,12.1
1293,Texas,1994,35,2,2,0,0,4,31,19,8,0,0,27,150,31,181,17.1
1294,Utah,1994,39,1,1,0,0,2,29,4,9,0,0,13,75,15,104,14.4
1295,Vermont,1994,3,7,4,0,0,11,30,33,16,0,0,49,150,60,180,33.3
1296,Virginia,1994,44,3,1,0,0,4,40,9,3,0,0,12,100,16,140,11.4
1297,Washington,1994,1,14,4,0,0,18,49,28,13,0,0,41,98,59,147,40.1
1298,West Virginia,1994,34,4,1,0,0,5,34,15,3,0,0,18,100,23,134,17.2
1299,Wisconsin,1994,9,2,7,0,0,9,33,16,11,0,0,27,99,36,132,27.3
1300,Wyoming,1994,17,1,4,0,0,5,30,6,11,0,0,17,60,22,90,24.4
1301,Alabama,1993,49,1,1,0,0,2,35,6,0,0,0,6,105,8,140,5.7
1302,Alaska,1993,21,3,0,1,0,4,20,5,4,0,0,9,40,13,60,21.7
1303,Arizona,1993,2,3,6,0,0,9,30,9,12,0,0,21,60,30,90,33.3
1304,Arkansas,1993,45,1,0,0,0,1,35,11,2,0,0,13,100,14,135,10.4
1305,California,1993,20,2,2,1,0,5,40,18,4,0,0,22,80,27,120,22.5
1306,Colorado,1993,3,3,5,0,0,8,35,16,11,0,0,27,65,35,100,35
1307,Connecticut,1993,13,4,4,0,0,8,36,27,12,0,0,39,151,47,187,25.1
1308,Deleware,1993,38,2,1,0,0,3,21,2,4,0,0,6,41,9,62,14.5
1309,Florida,1993,31,4,2,0,0,6,40,16,6,0,0,22,120,28,160,17.5
1310,Georgia,1993,32,4,2,0,0,6,56,23,12,0,0,35,180,41,236,17.4
1311,Hawaii,1993,17,5,1,0,0,6,25,10,2,0,0,12,51,18,76,23.7
1312,Idaho,1993,7,6,3,0,0,9,35,6,17,0,0,23,70,32,105,30.5
1313,Illinois,1993,18,5,6,0,0,11,59,15,15,0,0,30,118,41,177,23.2
1314,Indiana,1993,28,7,6,0,0,13,50,7,9,0,0,16,100,29,150,19.3
1315,Iowa,1993,37,4,2,0,0,6,50,8,8,0,0,16,100,22,150,14.7
1316,Kansas,1993,8,3,11,0,0,14,40,19,15,0,0,34,125,48,165,29.1
1317,Kentucky,1993,50,1,0,0,0,1,38,4,2,0,0,6,100,7,138,5.1
1318,Louisiana,1993,48,1,0,0,0,1,39,8,2,0,0,10,105,11,144,7.6
1319,Maine,1993,6,7,4,0,0,11,35,36,12,0,0,48,151,59,186,31.7
1320,Maryland,1993,15,10,0,0,0,10,47,31,5,0,0,36,141,46,188,24.5
1321,Massachusetts,1993,19,7,2,0,0,9,40,25,12,0,0,37,160,46,200,23
1322,Michigan,1993,24,2,1,0,0,3,38,15,12,0,0,27,110,30,148,20.3
1323,Minnesota,1993,10,12,8,0,0,20,67,25,10,0,0,35,134,55,201,27.4
1324,Mississippi,1993,44,3,1,0,0,4,52,13,2,0,0,15,122,19,174,10.9
1325,Missouri,1993,29,0,1,0,0,1,34,22,14,0,0,36,163,37,197,18.8
1326,Montana,1993,25,7,2,0,0,9,50,13,8,0,0,21,100,30,150,20
1327,Nebraska*,1993,23,0,0,0,0,10,49,0,0,0,0,0,0,10,49,20.4
1328,Nevada,1993,12,3,2,0,0,5,21,9,3,0,0,12,42,17,63,27
1329,New Hampshire,1993,5,6,3,0,0,9,24,59,74,0,0,133,400,142,424,33.5
1330,New Jersey,1993,41,1,0,0,0,1,40,2,12,0,0,14,80,15,120,12.5
1331,New Mexico,1993,27,6,2,0,0,8,42,9,5,0,0,14,70,22,112,19.6
1332,New York,1993,33,7,1,0,0,8,61,21,6,0,0,27,150,35,211,16.6
1333,North Carolina,1993,30,6,1,0,0,7,50,15,9,0,0,24,120,31,170,18.2
1334,North Dakota,1993,35,5,3,0,0,8,49,8,8,0,0,16,98,24,147,16.3
1335,Ohio,1993,22,1,4,0,0,5,33,13,10,0,0,23,99,28,132,21.2
1336,Oklahoma,1993,47,5,1,0,0,6,48,4,3,0,0,7,101,13,149,8.7
1337,Oregon,1993,9,7,1,0,0,8,30,11,6,0,0,17,60,25,90,27.8
1338,Pennsylvania,1993,46,3,1,0,0,4,50,11,10,0,0,21,203,25,253,9.9
1339,Rhode Island,1993,14,9,2,0,0,11,50,18,8,0,0,26,100,37,150,24.7
1340,South Carolina,1993,40,2,1,0,0,3,46,10,9,0,0,19,124,22,170,12.9
1341,South Dakota,1993,25,6,1,0,0,7,35,3,11,0,0,14,70,21,105,20
1342,Tennessee,1993,43,2,1,0,0,3,33,8,5,0,0,13,99,16,132,12.1
1343,Texas,1993,36,2,2,0,0,4,31,18,7,0,0,25,150,29,181,16
1344,Utah,1993,39,1,1,0,0,2,29,4,8,0,0,12,75,14,104,13.5
1345,Vermont,1993,4,7,4,0,0,11,30,34,16,0,0,50,150,61,180,33.9
1346,Virginia,1993,42,3,1,0,0,4,40,10,3,0,0,13,100,17,140,12.1
1347,Washington,1993,1,14,4,0,0,18,49,26,14,0,0,40,98,58,147,39.5
1348,West Virginia,1993,34,4,1,0,0,5,34,14,3,0,0,17,100,22,134,16.4
1349,Wisconsin,1993,11,2,7,0,0,9,33,16,11,0,0,27,99,36,132,27.3
1350,Wyoming,1993,16,1,4,0,0,5,30,6,11,0,0,17,60,22,90,24.4
1351,Alabama,1992,50,0,1,0,0,1,35,7,0,0,0,7,105,8,140,5.7
1352,Alaska,1992,15,1,0,3,0,4,20,5,5,0,0,10,40,14,60,23.3
1353,Arizona,1992,1,4,4,0,0,8,30,10,13,0,0,23,60,31,90,34.4
1354,Arkansas,1992,46,1,0,0,0,1,35,7,2,0,0,9,100,10,135,7.4
1355,California,1992,25,3,2,0,0,5,40,10,7,0,0,17,80,22,120,18.3
1356,Colorado,1992,5,3,5,0,0,8,35,11,12,0,0,23,65,31,100,31
1357,Connecticut,1992,16,4,3,0,0,7,36,21,15,0,0,36,151,43,187,23
1358,Deleware,1992,37,3,1,0,0,4,21,1,3,0,0,4,41,8,62,12.9
1359,Florida,1992,21,8,2,0,0,10,40,11,9,0,0,20,120,30,160,18.8
1360,Georgia,1992,34,2,1,0,0,3,56,25,6,0,0,31,180,34,236,14.4
1361,Hawaii,1992,8,6,1,0,0,7,25,11,3,0,0,14,51,21,76,27.6
1362,Idaho,1992,7,10,2,0,0,12,42,10,14,0,0,24,84,36,126,28.6
1363,Illinois,1992,22,6,6,0,0,12,59,11,10,0,0,21,118,33,177,18.6
1364,Indiana,1992,26,7,5,0,0,12,50,7,7,0,0,14,100,26,150,17.3
1365,Iowa,1992,32,4,2,0,0,6,50,11,5,0,0,16,100,22,150,14.7
1366,Kansas,1992,9,5,4,0,0,9,40,18,18,0,0,36,125,45,165,27.3
1367,Kentucky,1992,49,1,0,0,0,1,38,3,4,0,0,7,100,8,138,5.8
1368,Louisiana,1992,47,1,0,0,0,1,39,7,2,0,0,9,105,10,144,6.9
1369,Maine,1992,3,6,6,0,0,12,35,33,15,0,0,48,151,60,186,32.3
1370,Maryland,1992,14,9,0,0,0,9,47,30,5,0,0,35,141,44,188,23.4
1371,Massachusetts,1992,23,3,3,0,0,6,40,23,8,0,0,31,160,37,200,18.5
1372,Michigan,1992,30,2,1,0,0,3,38,10,9,0,0,19,110,22,148,14.9
1373,Minnesota,1992,17,9,5,0,0,14,67,17,11,0,0,28,134,42,201,20.9
1374,Mississippi,1992,48,2,1,0,0,3,52,8,1,0,0,9,122,12,174,6.9
1375,Missouri,1992,28,1,1,0,0,2,34,21,8,0,0,29,163,31,197,15.7
1376,Montana,1992,19,7,1,0,0,8,50,18,5,0,0,23,100,31,150,20.7
1377,Nebraska*,1992,24,0,0,0,0,9,49,0,0,0,0,0,0,9,49,18.4
1378,Nevada,1992,20,2,2,0,0,4,21,6,2,0,0,8,42,12,63,19
1379,New Hampshire,1992,6,4,3,0,0,7,24,45,79,0,0,124,400,131,424,33.3
1380,New Jersey,1992,40,1,1,0,0,2,40,2,11,0,0,13,80,15,120,12.5
1381,New Mexico,1992,35,3,1,0,0,4,42,7,5,0,0,12,70,16,112,14.3
1382,New York,1992,38,5,1,0,0,6,61,17,4,0,0,21,150,27,211,12.8
1383,North Carolina,1992,31,4,1,0,0,5,50,13,7,0,0,20,120,25,170,14.7
1384,North Dakota,1992,33,3,3,0,0,6,53,8,9,0,0,17,106,23,159,14.5
1385,Ohio,1992,29,1,3,0,0,4,33,12,4,0,0,16,99,20,132,15.2
1386,Oklahoma,1992,45,5,0,0,0,5,48,5,3,0,0,8,101,13,149,8.7
1387,Oregon,1992,12,6,1,0,0,7,30,9,6,0,0,15,60,22,90,24.4
1388,Pennsylvania,1992,44,3,1,0,0,4,50,9,11,0,0,20,203,24,253,9.5
1389,Rhode Island,1992,27,7,2,0,0,9,50,11,5,0,0,16,100,25,150,16.7
1390,South Carolina,1992,36,1,1,0,0,2,46,13,7,0,0,20,124,22,170,12.9
1391,South Dakota,1992,10,9,2,0,0,11,35,5,10,0,0,15,70,26,105,24.8
1392,Tennessee,1992,43,2,1,0,0,3,33,5,7,0,0,12,99,15,132,11.4
1393,Texas,1992,39,3,1,0,0,4,31,13,6,0,0,19,150,23,181,12.7
1394,Utah,1992,42,2,1,0,0,3,29,4,5,0,0,9,75,12,104,11.5
1395,Vermont,1992,4,7,0,0,0,7,30,27,22,0,0,49,150,56,180,31.1
1396,Virginia,1992,41,3,1,0,0,4,40,10,3,0,0,13,100,17,140,12.1
1397,Washington,1992,2,7,5,0,0,12,49,23,13,0,0,36,98,48,147,32.7
1398,West Virginia,1992,17,5,1,0,0,6,34,16,6,0,0,22,100,28,134,20.9
1399,Wisconsin,1992,13,1,4,0,0,5,33,19,8,0,0,27,99,32,132,24.2
1400,Wyoming,1992,11,3,0,0,0,3,30,7,13,0,0,20,64,23,94,24.5
1401,Alabama,1991,48,0,1,0,0,1,35,7,0,0,0,7,105,8,140,5.7
1402,Alaska,1991,14,1,0,3,0,4,20,5,5,0,0,10,40,14,60,23.3
1403,Arizona,1991,1,4,4,0,0,8,30,10,13,0,0,23,60,31,90,34.4
1404,Arkansas,1991,46,1,0,0,0,1,35,7,2,0,0,9,100,10,135,7.4
1405,California,1991,25,3,2,0,0,5,40,9,7,0,0,16,80,21,120,17.5
1406,Colorado,1991,6,3,5,0,0,8,35,11,12,0,0,23,65,31,100,31
1407,Connecticut,1991,16,4,3,0,0,7,36,21,15,0,0,36,151,43,187,23
1408,Deleware,1991,37,3,1,0,0,4,21,1,3,0,0,4,41,8,62,12.9
1409,Florida,1991,22,8,2,0,0,10,40,11,9,0,0,20,120,30,160,18.8
1410,Georgia,1991,34,2,1,0,0,3,56,24,6,0,0,30,180,33,236,14
1411,Hawaii,1991,8,6,1,0,0,7,25,11,3,0,0,14,51,21,76,27.6
1412,Idaho,1991,7,10,2,0,0,12,42,10,14,0,0,24,84,36,126,28.6
1413,Illinois,1991,23,6,6,0,0,12,59,11,10,0,0,21,118,33,177,18.6
1414,Indiana,1991,26,7,5,0,0,12,50,7,7,0,0,14,100,26,150,17.3
1415,Iowa,1991,31,4,2,0,0,6,50,11,5,0,0,16,100,22,150,14.7
1416,Kansas,1991,9,5,4,0,0,9,40,17,18,0,0,35,125,44,165,26.7
1417,Kentucky,1991,49,1,0,0,0,1,38,2,4,0,0,6,100,7,138,5.1
1418,Louisiana,1991,50,1,0,0,0,1,39,3,0,0,0,3,105,4,144,2.8
1419,Maine,1991,2,6,6,0,0,12,35,34,15,0,0,49,151,61,186,32.8
1420,Maryland,1991,12,9,0,0,0,9,47,31,5,0,0,36,141,45,188,23.9
1421,Massachusetts,1991,21,3,4,0,0,7,40,23,8,0,0,31,160,38,200,19
1422,Michigan,1991,30,2,1,0,0,3,38,11,8,0,0,19,110,22,148,14.9
1423,Minnesota,1991,17,9,5,0,0,14,67,18,11,0,0,29,134,43,201,21.4
1424,Mississippi,1991,47,3,1,0,0,4,52,8,0,0,0,8,122,12,174,6.9
1425,Missouri,1991,27,1,1,0,0,2,34,22,8,0,0,30,163,32,197,16.2
1426,Montana,1991,19,7,1,0,0,8,50,18,5,0,0,23,100,31,150,20.7
1427,Nebraska*,1991,24,0,0,0,0,9,49,0,0,0,0,0,0,9,49,18.4
1428,Nevada,1991,20,2,2,0,0,4,21,6,2,0,0,8,42,12,63,19
1429,New Hampshire,1991,3,4,3,0,0,7,24,49,79,0,0,128,400,135,424,31.8
1430,New Jersey,1991,43,1,1,0,0,2,40,4,7,0,0,11,80,13,120,10.8
1431,New Mexico,1991,35,3,1,0,0,4,42,6,5,0,0,11,70,15,112,13.4
1432,New York,1991,36,5,1,0,0,6,61,18,4,0,0,22,150,28,211,13.3
1433,North Carolina,1991,32,4,1,0,0,5,50,13,7,0,0,20,120,25,170,14.7
1434,North Dakota,1991,33,3,3,0,0,6,53,8,9,0,0,17,106,23,159,14.5
1435,Ohio,1991,29,1,3,0,0,4,33,12,4,0,0,16,99,20,132,15.2
1436,Oklahoma,1991,45,5,0,0,0,5,48,5,3,0,0,8,101,13,149,8.7
1437,Oregon,1991,14,6,1,0,0,7,30,8,6,0,0,14,60,21,90,23.3
1438,Pennsylvania,1991,44,3,1,0,0,4,50,9,11,0,0,20,203,24,253,9.5
1439,Rhode Island,1991,28,6,2,0,0,8,50,11,5,0,0,16,100,24,150,16
1440,South Carolina,1991,42,1,1,0,0,2,46,12,5,0,0,17,124,19,170,11.2
1441,South Dakota,1991,10,9,2,0,0,11,35,5,10,0,0,15,70,26,105,24.8
1442,Tennessee,1991,41,2,1,0,0,3,33,5,7,0,0,12,99,15,132,11.4
1443,Texas,1991,38,3,1,0,0,4,31,13,6,0,0,19,150,23,181,12.7
1444,Utah,1991,40,2,1,0,0,3,29,4,5,0,0,9,75,12,104,11.5
1445,Vermont,1991,4,7,0,0,0,7,30,27,23,0,0,50,150,57,180,31.7
1446,Virginia,1991,39,2,1,0,0,3,40,9,5,0,0,14,100,17,140,12.1
1447,Washington,1991,5,6,5,0,0,11,49,22,13,0,0,35,98,46,147,31.3
1448,West Virginia,1991,18,5,1,0,0,6,34,16,6,0,0,22,100,28,134,20.9
1449,Wisconsin,1991,13,1,4,0,0,5,33,19,7,0,0,26,99,31,132,23.5
1450,Wyoming,1991,11,3,0,0,0,3,30,7,13,0,0,20,64,23,94,24.5
1451,Alabama,1990,49,0,1,0,0,1,35,7,0,0,0,7,105,8,140,5.7
1452,Alaska,1990,16,1,0,3,0,4,20,4,4,0,0,8,40,12,60,20
1453,Arizona,1990,4,2,3,0,0,5,30,9,13,0,0,22,60,27,90,30
1454,Arkansas,1990,45,2,0,0,0,2,35,7,1,0,0,8,100,10,135,7.4
1455,California,1990,27,3,2,0,0,5,40,7,7,0,0,14,80,19,120,15.8
1456,Colorado,1990,6,2,5,0,0,7,35,9,13,0,0,22,65,29,100,29
1457,Connecticut,1990,14,4,3,0,0,7,36,19,15,0,0,34,151,41,187,21.9
1458,Deleware,1990,26,2,2,0,0,4,21,2,4,0,0,6,41,10,62,16.1
1459,Florida,1990,25,7,3,0,0,10,40,8,8,0,0,16,120,26,160,16.3
1460,Georgia,1990,41,1,1,0,0,2,56,18,4,0,0,22,180,24,236,10.2
1461,Hawaii,1990,10,6,1,0,0,7,25,10,1,0,0,11,51,18,76,23.7
1462,Idaho,1990,9,5,4,0,0,9,42,6,16,0,0,22,84,31,126,24.6
1463,Illinois,1990,20,6,6,0,0,12,59,9,12,0,0,21,118,33,177,18.6
1464,Indiana,1990,33,6,5,0,0,11,50,4,6,0,0,10,100,21,150,14
1465,Iowa,1990,24,3,3,0,0,6,50,13,6,0,0,19,100,25,150,16.7
1466,Kansas,1990,8,5,4,0,0,9,40,16,17,0,0,33,125,42,165,25.5
1467,Kentucky,1990,47,2,0,0,0,2,38,3,3,0,0,6,100,8,138,5.8
1468,Louisiana,1990,50,0,0,0,0,0,39,3,0,0,0,3,105,3,144,2.1
1469,Maine,1990,3,5,5,0,0,10,35,29,19,0,0,48,151,58,186,31.2
1470,Maryland,1990,12,7,1,0,0,8,47,31,4,0,0,35,141,43,188,22.9
1471,Massachusetts,1990,23,3,2,0,0,5,40,22,7,0,0,29,160,34,200,17
1472,Michigan,1990,30,1,1,0,0,2,38,12,8,0,0,20,110,22,148,14.9
1473,Minnesota,1990,21,6,4,0,0,10,67,17,10,0,0,27,134,37,201,18.4
1474,Mississippi,1990,48,2,1,0,0,3,52,7,0,0,0,7,122,10,174,5.7
1475,Missouri,1990,31,1,1,0,0,2,34,19,8,0,0,27,163,29,197,14.7
1476,Montana,1990,22,5,1,0,0,6,50,16,5,0,0,21,100,27,150,18
1477,Nebraska*,1990,15,0,0,0,0,10,49,0,0,0,0,0,0,10,49,20.4
1478,Nevada,1990,13,2,2,0,0,4,21,8,2,0,0,10,42,14,63,22.2
1479,New Hampshire,1990,2,2,4,0,0,6,24,48,82,0,0,130,400,136,424,32.1
1480,New Jersey,1990,38,2,1,0,0,3,40,4,6,0,0,10,80,13,120,10.8
1481,New Mexico,1990,34,3,1,0,0,4,42,5,6,0,0,11,70,15,112,13.4
1482,New York,1990,37,5,1,0,0,6,61,14,3,0,0,17,150,23,211,10.9
1483,North Carolina,1990,32,2,2,0,0,4,50,12,8,0,0,20,120,24,170,14.1
1484,North Dakota,1990,29,3,2,0,0,5,53,10,9,0,0,19,106,24,159,15.1
1485,Ohio,1990,35,1,2,0,0,3,33,11,3,0,0,14,99,17,132,12.9
1486,Oklahoma,1990,44,5,1,0,0,6,48,6,1,0,0,7,101,13,149,8.7
1487,Oregon,1990,16,6,1,0,0,7,30,6,5,0,0,11,60,18,90,20
1488,Pennsylvania,1990,46,2,0,0,0,2,50,7,8,0,0,15,203,17,253,6.7
1489,Rhode Island,1990,28,5,4,0,0,9,50,11,3,0,0,14,100,23,150,15.3
1490,South Carolina,1990,43,1,1,0,0,2,46,10,3,0,0,13,124,15,170,8.8
1491,South Dakota,1990,19,6,1,0,0,7,35,6,7,0,0,13,70,20,105,19
1492,Tennessee,1990,42,1,1,0,0,2,33,4,7,0,0,11,99,13,132,9.8
1493,Texas,1990,40,2,1,0,0,3,31,11,5,0,0,16,150,19,181,10.5
1494,Utah,1990,36,1,0,0,0,1,29,5,6,0,0,11,75,12,104,11.5
1495,Vermont,1990,1,6,0,0,0,6,30,30,24,0,0,54,150,60,180,33.3
1496,Virginia,1990,39,2,1,0,0,3,40,8,4,0,0,12,100,15,140,10.7
1497,Washington,1990,5,5,5,0,0,10,49,22,11,0,0,33,98,43,147,29.3
1498,West Virginia,1990,18,6,1,0,0,7,34,16,3,0,0,19,100,26,134,19.4
1499,Wisconsin,1990,7,1,3,0,0,4,33,18,12,0,0,30,99,34,132,25.8
1500,Wyoming,1990,11,4,0,0,0,4,30,7,11,0,0,18,64,22,94,23.4
1501,Alabama,1989,48,0,1,0,0,1,35,7,0,0,0,7,105,8,140,5.7
1502,Alaska,1989,14,1,0,3,0,4,20,5,4,0,0,9,40,13,60,21.7
1503,Arizona,1989,4,2,3,0,0,5,30,9,13,0,0,22,60,27,90,30
1504,Arkansas,1989,45,2,0,0,0,2,35,7,1,0,0,8,100,10,135,7.4
1505,California,1989,27,2,2,0,0,4,40,8,7,0,0,15,80,19,120,15.8
1506,Colorado,1989,5,2,5,0,0,7,35,9,13,0,0,22,65,29,100,29
1507,Connecticut,1989,13,4,3,0,0,7,36,19,15,0,0,34,151,41,187,21.9
1508,Deleware,1989,26,2,2,0,0,4,21,2,4,0,0,6,41,10,62,16.1
1509,Florida,1989,25,7,3,0,0,10,40,8,8,0,0,16,120,26,160,16.3
1510,Georgia,1989,40,1,1,0,0,2,56,18,4,0,0,22,180,24,236,10.2
1511,Hawaii,1989,10,4,3,0,0,7,25,9,2,0,0,11,51,18,76,23.7
1512,Idaho,1989,9,6,3,0,0,9,42,5,17,0,0,22,84,31,126,24.6
1513,Illinois,1989,18,6,6,0,0,12,59,9,12,0,0,21,118,33,177,18.6
1514,Indiana,1989,33,6,5,0,0,11,50,5,6,0,0,11,100,22,150,14.7
1515,Iowa,1989,24,3,3,0,0,6,50,13,6,0,0,19,100,25,150,16.7
1516,Kansas,1989,8,5,4,0,0,9,40,17,17,0,0,34,125,43,165,26.1
1517,Kentucky,1989,49,1,0,0,0,1,38,3,3,0,0,6,100,7,138,5.1
1518,Louisiana,1989,50,0,0,0,0,0,39,3,0,0,0,3,105,3,144,2.1
1519,Maine,1989,2,5,5,0,0,10,35,28,19,0,0,47,151,57,186,30.7
1520,Maryland,1989,12,6,0,0,0,6,47,32,4,0,0,36,141,42,188,22.3
1521,Massachusetts,1989,23,4,1,0,0,5,40,22,8,0,0,30,160,35,200,17.5
1522,Michigan,1989,30,1,1,0,0,2,38,12,8,0,0,20,110,22,148,14.9
1523,Minnesota,1989,19,6,4,0,0,10,67,17,10,0,0,27,134,37,201,18.4
1524,Mississippi,1989,47,2,1,0,0,3,52,7,0,0,0,7,122,10,174,5.7
1525,Missouri,1989,31,1,1,0,0,2,34,19,8,0,0,27,163,29,197,14.7
1526,Montana,1989,21,5,1,0,0,6,50,16,5,0,0,21,100,27,150,18
1527,Nebraska*,1989,20,0,0,0,0,9,49,0,0,0,0,0,0,9,49,18.4
1528,Nevada,1989,15,1,2,0,0,3,21,8,2,0,0,10,42,13,63,20.6
1529,New Hampshire,1989,1,2,4,0,0,6,24,48,82,0,0,130,400,136,424,32.1
1530,New Jersey,1989,43,2,1,0,0,3,40,2,6,0,0,8,80,11,120,9.2
1531,New Mexico,1989,34,3,1,0,0,4,42,5,6,0,0,11,70,15,112,13.4
1532,New York,1989,37,5,1,0,0,6,61,15,3,0,0,18,150,24,211,11.4
1533,North Carolina,1989,32,3,1,0,0,4,50,12,9,0,0,21,120,25,170,14.7
1534,North Dakota,1989,29,3,2,0,0,5,53,10,9,0,0,19,106,24,159,15.1
1535,Ohio,1989,35,1,2,0,0,3,33,11,3,0,0,14,99,17,132,12.9
1536,Oklahoma,1989,44,5,1,0,0,6,48,6,1,0,0,7,101,13,149,8.7
1537,Oregon,1989,16,6,1,0,0,7,30,6,5,0,0,11,60,18,90,20
1538,Pennsylvania,1989,46,2,0,0,0,2,50,7,8,0,0,15,203,17,253,6.7
1539,Rhode Island,1989,28,5,4,0,0,9,50,11,3,0,0,14,100,23,150,15.3
1540,South Carolina,1989,42,1,1,0,0,2,46,10,4,0,0,14,124,16,170,9.4
1541,South Dakota,1989,17,6,1,0,0,7,35,6,7,0,0,13,70,20,105,19
1542,Tennessee,1989,41,1,1,0,0,2,33,4,7,0,0,11,99,13,132,9.8
1543,Texas,1989,39,2,1,0,0,3,31,11,5,0,0,16,150,19,181,10.5
1544,Utah,1989,36,1,0,0,0,1,29,5,6,0,0,11,75,12,104,11.5
1545,Vermont,1989,3,6,0,0,0,6,30,26,23,0,0,49,150,55,180,30.6
1546,Virginia,1989,38,2,1,0,0,3,40,9,3,0,0,12,100,15,140,10.7
1547,Washington,1989,6,5,5,0,0,10,49,22,10,0,0,32,98,42,147,28.6
1548,West Virginia,1989,22,5,1,0,0,6,34,16,2,0,0,18,100,24,134,17.9
1549,Wisconsin,1989,7,1,3,0,0,4,33,18,12,0,0,30,99,34,132,25.8
1550,Wyoming,1989,11,4,0,0,0,4,30,7,11,0,0,18,64,22,94,23.4
1551,Alabama,1988,49,0,1,0,0,1,35,7,0,0,0,7,105,8,140,5.7
1552,Alaska,1988,14,1,0,2,0,3,20,5,4,0,0,9,40,12,60,20
1553,Arizona,1988,6,2,4,0,0,6,30,6,9,0,0,15,60,21,90,23.3
1554,Arkansas,1988,46,1,0,0,0,1,35,7,1,0,0,8,100,9,135,6.7
1555,California,1988,30,2,2,0,0,4,40,8,5,0,0,13,80,17,120,14.2
1556,Colorado,1988,3,1,3,0,0,4,35,7,17,0,0,24,65,28,100,28
1557,Connecticut,1988,9,4,2,0,0,6,36,19,15,0,0,34,151,40,187,21.4
1558,Deleware,1988,21,2,2,0,0,4,21,2,4,0,0,6,41,10,62,16.1
1559,Florida,1988,13,6,4,0,0,10,40,13,10,0,0,23,120,33,160,20.6
1560,Georgia,1988,35,1,1,0,0,2,56,19,5,0,0,24,180,26,236,11
1561,Hawaii,1988,11,5,3,0,0,8,25,6,2,0,0,8,51,16,76,21.1
1562,Idaho,1988,8,5,2,0,0,7,42,6,14,0,0,20,84,27,126,21.4
1563,Illinois,1988,19,6,6,0,0,12,59,9,11,0,0,20,118,32,177,18.1
1564,Indiana,1988,32,5,3,0,0,8,50,5,6,0,0,11,100,19,150,12.7
1565,Iowa,1988,29,2,2,0,0,4,50,11,7,0,0,18,100,22,150,14.7
1566,Kansas,1988,16,2,3,0,0,5,40,12,14,0,0,26,125,31,165,18.8
1567,Kentucky,1988,47,2,0,0,0,2,38,3,3,0,0,6,100,8,138,5.8
1568,Louisiana,1988,50,0,0,0,0,0,39,4,0,0,0,4,105,4,144,2.8
1569,Maine,1988,2,4,6,0,0,10,35,24,19,0,0,43,151,53,186,28.5
1570,Maryland,1988,12,6,0,0,0,6,47,29,4,0,0,33,141,39,188,20.7
1571,Massachusetts,1988,17,5,1,0,0,6,40,22,9,0,0,31,160,37,200,18.5
1572,Michigan,1988,28,1,1,0,0,2,38,14,6,0,0,20,110,22,148,14.9
1573,Minnesota,1988,26,6,3,0,0,9,67,15,7,0,0,22,134,31,201,15.4
1574,Mississippi,1988,48,2,1,0,0,3,52,7,0,0,0,7,122,10,174,5.7
1575,Missouri,1988,24,1,1,0,0,2,34,22,7,0,0,29,163,31,197,15.7
1576,Montana,1988,27,5,1,0,0,6,50,13,4,0,0,17,100,23,150,15.3
1577,Nebraska*,1988,18,0,0,0,0,9,49,0,0,0,0,0,0,9,49,18.4
1578,Nevada,1988,23,0,2,0,0,2,21,6,2,0,0,8,42,10,63,15.9
1579,New Hampshire,1988,1,3,5,0,0,8,24,50,80,0,0,130,400,138,424,32.6
1580,New Jersey,1988,40,2,1,0,0,3,40,2,6,0,0,8,80,11,120,9.2
1581,New Mexico,1988,38,0,2,0,0,2,42,4,5,0,0,9,70,11,112,9.8
1582,New York,1988,36,4,1,0,0,5,61,15,2,0,0,17,150,22,211,10.4
1583,North Carolina,1988,31,4,0,0,0,4,50,13,7,0,0,20,120,24,170,14.1
1584,North Dakota,1988,33,3,1,0,0,4,53,8,8,0,0,16,106,20,159,12.6
1585,Ohio,1988,34,1,1,0,0,2,33,9,4,0,0,13,99,15,132,11.4
1586,Oklahoma,1988,42,4,2,0,0,6,48,6,1,0,0,7,101,13,149,8.7
1587,Oregon,1988,20,4,1,0,0,5,30,7,3,0,0,10,60,15,90,16.7
1588,Pennsylvania,1988,45,2,0,0,0,2,50,6,9,0,0,15,203,17,253,6.7
1589,Rhode Island,1988,22,5,5,0,0,10,50,10,4,0,0,14,100,24,150,16
1590,South Carolina,1988,44,1,1,0,0,2,46,9,2,0,0,11,124,13,170,7.6
1591,South Dakota,1988,14,3,2,0,0,5,35,5,11,0,0,16,70,21,105,20
1592,Tennessee,1988,41,1,0,0,0,1,33,5,6,0,0,11,99,12,132,9.1
1593,Texas,1988,39,2,1,0,0,3,31,10,4,0,0,14,150,17,181,9.4
1594,Utah,1988,43,1,0,0,0,1,29,3,4,0,0,7,75,8,104,7.7
1595,Vermont,1988,4,3,0,0,0,3,30,23,20,0,0,43,150,46,180,25.6
1596,Virginia,1988,37,2,1,0,0,3,40,9,2,0,0,11,100,14,140,10
1597,Washington,1988,5,4,5,0,0,9,49,20,8,0,0,28,98,37,147,25.2
1598,West Virginia,1988,25,2,1,0,0,3,34,17,1,0,0,18,100,21,134,15.7
1599,Wisconsin,1988,10,1,3,0,0,4,33,14,10,0,0,24,99,28,132,21.2
1600,Wyoming,1988,7,3,0,0,0,3,30,8,10,0,0,18,64,21,94,22.3
1601,Alabama,1987,47,0,1,0,0,1,35,7,0,0,0,7,105,8,140,5.7
1602,Alaska,1987,14,1,0,2,0,3,20,5,4,0,0,9,40,12,60,20
1603,Arizona,1987,6,2,4,0,0,6,30,6,9,0,0,15,60,21,90,23.3
1604,Arkansas,1987,45,1,0,0,0,1,35,7,1,0,0,8,100,9,135,6.7
1605,California,1987,30,2,2,0,0,4,40,8,5,0,0,13,80,17,120,14.2
1606,Colorado,1987,3,1,2,0,0,3,35,8,17,0,0,25,65,28,100,28
1607,Connecticut,1987,8,4,2,0,0,6,36,19,16,0,0,35,151,41,187,21.9
1608,Deleware,1987,21,2,2,0,0,4,21,2,4,0,0,6,41,10,62,16.1
1609,Florida,1987,13,6,4,0,0,10,40,13,10,0,0,23,120,33,160,20.6
1610,Georgia,1987,35,1,1,0,0,2,56,19,5,0,0,24,180,26,236,11
1611,Hawaii,1987,11,4,3,0,0,7,25,7,2,0,0,9,51,16,76,21.1
1612,Idaho,1987,9,5,2,0,0,7,42,6,14,0,0,20,84,27,126,21.4
1613,Illinois,1987,19,6,6,0,0,12,59,9,11,0,0,20,118,32,177,18.1
1614,Indiana,1987,32,5,3,0,0,8,50,5,6,0,0,11,100,19,150,12.7
1615,Iowa,1987,29,2,2,0,0,4,50,11,7,0,0,18,100,22,150,14.7
1616,Kansas,1987,16,2,3,0,0,5,40,12,14,0,0,26,125,31,165,18.8
1617,Kentucky,1987,48,2,0,0,0,2,38,3,2,0,0,5,100,7,138,5.1
1618,Louisiana,1987,49,0,0,0,0,0,39,6,0,0,0,6,105,6,144,4.2
1619,Maine,1987,2,4,6,0,0,10,35,24,19,0,0,43,151,53,186,28.5
1620,Maryland,1987,12,6,0,0,0,6,47,29,4,0,0,33,141,39,188,20.7
1621,Massachusetts,1987,17,5,1,0,0,6,40,22,9,0,0,31,160,37,200,18.5
1622,Michigan,1987,28,1,1,0,0,2,38,14,6,0,0,20,110,22,148,14.9
1623,Minnesota,1987,26,6,3,0,0,9,67,15,7,0,0,22,134,31,201,15.4
1624,Mississippi,1987,50,0,0,0,0,0,52,4,0,0,0,4,122,4,174,2.3
1625,Missouri,1987,24,1,1,0,0,2,34,22,7,0,0,29,163,31,197,15.7
1626,Montana,1987,27,5,1,0,0,6,50,13,4,0,0,17,100,23,150,15.3
1627,Nebraska*,1987,18,0,0,0,0,9,49,0,0,0,0,0,0,9,49,18.4
1628,Nevada,1987,23,0,2,0,0,2,21,6,2,0,0,8,42,10,63,15.9
1629,New Hampshire,1987,1,3,5,0,0,8,24,50,80,0,0,130,400,138,424,32.6
1630,New Jersey,1987,37,2,1,0,0,3,40,2,7,0,0,9,80,12,120,10
1631,New Mexico,1987,38,0,2,0,0,2,42,4,5,0,0,9,70,11,112,9.8
1632,New York,1987,36,4,1,0,0,5,61,15,3,0,0,18,150,23,211,10.9
1633,North Carolina,1987,31,4,0,0,0,4,50,13,7,0,0,20,120,24,170,14.1
1634,North Dakota,1987,33,3,1,0,0,4,53,8,8,0,0,16,106,20,159,12.6
1635,Ohio,1987,34,1,1,0,0,2,33,9,4,0,0,13,99,15,132,11.4
1636,Oklahoma,1987,41,4,2,0,0,6,48,6,1,0,0,7,101,13,149,8.7
1637,Oregon,1987,20,4,2,0,0,6,30,7,3,0,0,10,60,16,90,17.8
1638,Pennsylvania,1987,46,2,0,0,0,2,50,5,9,0,0,14,203,16,253,6.3
1639,Rhode Island,1987,22,5,5,0,0,10,50,10,4,0,0,14,100,24,150,16
1640,South Carolina,1987,43,1,1,0,0,2,46,9,2,0,0,11,124,13,170,7.6
1641,South Dakota,1987,14,3,2,0,0,5,35,5,11,0,0,16,70,21,105,20
1642,Tennessee,1987,40,1,0,0,0,1,33,5,6,0,0,11,99,12,132,9.1
1643,Texas,1987,39,2,1,0,0,3,31,10,4,0,0,14,150,17,181,9.4
1644,Utah,1987,42,1,0,0,0,1,29,3,4,0,0,7,75,8,104,7.7
1645,Vermont,1987,5,3,0,0,0,3,30,22,19,0,0,41,150,44,180,24.4
1646,Virginia,1987,44,0,0,0,0,0,40,9,0,1,0,10,100,10,140,7.1
1647,Washington,1987,4,4,4,0,0,8,49,19,10,0,0,29,98,37,147,25.2
1648,West Virginia,1987,25,2,1,0,0,3,34,17,1,0,0,18,100,21,134,15.7
1649,Wisconsin,1987,10,1,3,0,0,4,33,14,10,0,0,24,99,28,132,21.2
1650,Wyoming,1987,7,3,0,0,0,3,30,8,10,0,0,18,64,21,94,22.3
1651,Alabama,1986,46,1,1,0,0,2,35,7,0,0,0,7,105,9,140,6.4
1652,Alaska,1986,15,1,0,3,0,4,20,4,3,0,0,7,40,11,60,18.3
1653,Arizona,1986,8,1,3,0,0,4,30,5,9,0,0,14,60,18,90,20
1654,Arkansas,1986,42,1,0,0,0,1,35,8,1,0,0,9,100,10,135,7.4
1655,California,1986,30,2,2,0,0,4,40,7,4,0,0,11,80,15,120,12.5
1656,Colorado,1986,4,2,3,0,0,5,35,6,13,0,0,19,65,24,100,24
1657,Connecticut,1986,7,2,3,0,0,5,36,12,24,0,0,36,151,41,187,21.9
1658,Deleware,1986,21,2,1,0,0,3,21,3,4,0,0,7,41,10,62,16.1
1659,Florida,1986,10,7,2,0,0,9,40,11,11,0,0,22,120,31,160,19.4
1660,Georgia,1986,37,2,0,0,0,2,56,17,4,0,0,21,180,23,236,9.7
1661,Hawaii,1986,14,4,2,0,0,6,25,4,4,0,0,8,51,14,76,18.4
1662,Idaho,1986,12,5,2,0,0,7,42,4,13,0,0,17,84,24,126,19
1663,Illinois,1986,18,4,6,0,0,10,59,8,12,0,0,20,118,30,177,16.9
1664,Indiana,1986,29,3,3,0,0,6,50,7,6,0,0,13,100,19,150,12.7
1665,Iowa,1986,24,1,2,0,0,3,50,13,6,0,0,19,100,22,150,14.7
1666,Kansas,1986,16,2,3,0,0,5,40,11,14,0,0,25,125,30,165,18.2
1667,Kentucky,1986,45,2,0,0,0,2,38,5,2,0,0,7,100,9,138,6.5
1668,Louisiana,1986,49,0,0,0,0,0,39,5,0,0,0,5,105,5,144,3.5
1669,Maine,1986,6,6,3,0,0,9,35,17,18,0,0,35,151,44,186,23.7
1670,Maryland,1986,11,3,0,0,0,3,47,29,4,0,0,33,141,36,188,19.1
1671,Massachusetts,1986,19,4,1,0,0,5,40,20,8,0,0,28,160,33,200,16.5
1672,Michigan,1986,35,1,1,0,0,2,38,9,5,0,0,14,110,16,148,10.8
1673,Minnesota,1986,26,5,4,0,0,9,67,12,8,0,0,20,134,29,201,14.4
1674,Mississippi,1986,48,0,0,0,0,0,52,4,0,0,0,4,122,4,174,2.3
1675,Missouri,1986,28,1,1,0,0,2,34,17,7,0,0,24,163,26,197,13.2
1676,Montana,1986,24,4,1,0,0,5,50,13,4,0,0,17,100,22,150,14.7
1677,Nebraska*,1986,20,0,0,0,0,8,49,0,0,0,0,0,0,8,49,16.3
1678,Nevada,1986,22,1,2,0,0,3,21,3,4,0,0,7,42,10,63,15.9
1679,New Hampshire,1986,1,0,7,0,0,7,24,44,89,0,0,133,400,140,424,33
1680,New Jersey,1986,36,2,1,0,0,3,40,2,7,0,0,9,80,12,120,10
1681,New Mexico,1986,32,0,2,0,0,2,42,1,10,0,0,11,70,13,112,11.6
1682,New York,1986,34,4,1,0,0,5,61,16,2,0,0,18,150,23,211,10.9
1683,North Carolina,1986,31,4,0,0,0,4,50,9,7,0,0,16,120,20,170,11.8
1684,North Dakota,1986,33,3,0,0,0,3,53,6,9,0,0,15,106,18,159,11.3
1685,Ohio,1986,38,1,1,0,0,2,33,7,3,0,0,10,99,12,132,9.1
1686,Oklahoma,1986,40,2,1,0,0,3,48,6,4,0,0,10,101,13,149,8.7
1687,Oregon,1986,8,4,2,0,0,6,30,8,4,0,0,12,60,18,90,20
1688,Pennsylvania,1986,48,2,0,0,0,2,50,3,8,0,0,11,203,13,253,5.1
1689,Rhode Island,1986,23,3,5,0,0,8,50,11,4,0,0,15,100,23,150,15.3
1690,South Carolina,1986,47,2,0,0,0,2,46,7,1,0,0,8,124,10,170,5.9
1691,South Dakota,1986,27,2,2,0,0,4,35,1,10,0,0,11,70,15,105,14.3
1692,Tennessee,1986,41,1,0,0,0,1,33,4,6,0,0,10,99,11,132,8.3
1693,Texas,1986,39,0,1,0,0,1,31,10,5,0,0,15,150,16,181,8.8
1694,Utah,1986,44,0,1,0,0,1,29,2,4,0,0,6,75,7,104,6.7
1695,Vermont,1986,2,4,0,0,0,4,30,23,20,0,0,43,150,47,180,26.1
1696,Virginia,1986,43,0,0,0,0,0,40,9,0,1,0,10,100,10,140,7.1
1697,Washington,1986,5,4,3,0,0,7,49,16,12,0,0,28,98,35,147,23.8
1698,West Virginia,1986,17,2,1,0,0,3,34,16,4,0,0,20,100,23,134,17.2
1699,Wisconsin,1986,13,1,2,0,0,3,33,12,10,0,0,22,99,25,132,18.9
1700,Wyoming,1986,3,2,0,0,0,2,30,11,11,0,0,22,64,24,94,25.5
1701,Alabama,1985,46,1,1,0,0,2,35,7,0,0,0,7,105,9,140,6.4
1702,Alaska,1985,15,1,0,3,0,4,20,4,3,0,0,7,40,11,60,18.3
1703,Arizona,1985,8,1,3,0,0,4,30,5,9,0,0,14,60,18,90,20
1704,Arkansas,1985,43,1,0,0,0,1,35,8,1,0,0,9,100,10,135,7.4
1705,California,1985,30,2,2,0,0,4,40,7,4,0,0,11,80,15,120,12.5
1706,Colorado,1985,4,2,3,0,0,5,35,6,13,0,0,19,65,24,100,24
1707,Connecticut,1985,7,2,3,0,0,5,36,12,24,0,0,36,151,41,187,21.9
1708,Deleware,1985,21,2,1,0,0,3,21,3,4,0,0,7,41,10,62,16.1
1709,Florida,1985,10,7,2,0,0,9,40,11,11,0,0,22,120,31,160,19.4
1710,Georgia,1985,37,2,0,0,0,2,56,17,4,0,0,21,180,23,236,9.7
1711,Hawaii,1985,14,4,2,0,0,6,25,4,4,0,0,8,51,14,76,18.4
1712,Idaho,1985,12,5,2,0,0,7,42,4,13,0,0,17,84,24,126,19
1713,Illinois,1985,18,4,6,0,0,10,59,8,12,0,0,20,118,30,177,16.9
1714,Indiana,1985,29,3,3,0,0,6,50,7,6,0,0,13,100,19,150,12.7
1715,Iowa,1985,24,1,2,0,0,3,50,13,6,0,0,19,100,22,150,14.7
1716,Kansas,1985,16,2,3,0,0,5,40,11,14,0,0,25,125,30,165,18.2
1717,Kentucky,1985,45,2,0,0,0,2,38,5,2,0,0,7,100,9,138,6.5
1718,Louisiana,1985,49,0,0,0,0,0,39,5,0,0,0,5,105,5,144,3.5
1719,Maine,1985,6,6,3,0,0,9,35,17,18,0,0,35,151,44,186,23.7
1720,Maryland,1985,11,3,0,0,0,3,47,29,4,0,0,33,141,36,188,19.1
1721,Massachusetts,1985,19,4,1,0,0,5,40,20,8,0,0,28,160,33,200,16.5
1722,Michigan,1985,35,1,1,0,0,2,38,9,5,0,0,14,110,16,148,10.8
1723,Minnesota,1985,26,5,4,0,0,9,67,12,8,0,0,20,134,29,201,14.4
1724,Mississippi,1985,50,0,0,0,0,0,52,4,0,0,0,4,122,4,174,2.3
1725,Missouri,1985,28,1,1,0,0,2,34,17,7,0,0,24,163,26,197,13.2
1726,Montana,1985,24,4,1,0,0,5,50,13,4,0,0,17,100,22,150,14.7
1727,Nebraska*,1985,20,0,0,0,0,8,49,0,0,0,0,0,0,8,49,16.3
1728,Nevada,1985,22,1,2,0,0,3,21,3,4,0,0,7,42,10,63,15.9
1729,New Hampshire,1985,1,0,7,0,0,7,24,44,89,0,0,133,400,140,424,33
1730,New Jersey,1985,36,2,1,0,0,3,40,5,4,0,0,9,80,12,120,10
1731,New Mexico,1985,32,0,2,0,0,2,42,1,10,0,0,11,70,13,112,11.6
1732,New York,1985,33,4,1,0,0,5,61,17,2,0,0,19,150,24,211,11.4
1733,North Carolina,1985,31,4,0,0,0,4,50,9,7,0,0,16,120,20,170,11.8
1734,North Dakota,1985,34,3,0,0,0,3,53,6,9,0,0,15,106,18,159,11.3
1735,Ohio,1985,38,1,1,0,0,2,33,7,3,0,0,10,99,12,132,9.1
1736,Oklahoma,1985,40,2,1,0,0,3,48,6,4,0,0,10,101,13,149,8.7
1737,Oregon,1985,8,4,2,0,0,6,30,8,4,0,0,12,60,18,90,20
1738,Pennsylvania,1985,48,2,0,0,0,2,50,3,8,0,0,11,203,13,253,5.1
1739,Rhode Island,1985,23,3,5,0,0,8,50,11,4,0,0,15,100,23,150,15.3
1740,South Carolina,1985,47,2,0,0,0,2,46,7,1,0,0,8,124,10,170,5.9
1741,South Dakota,1985,27,2,2,0,0,4,35,1,10,0,0,11,70,15,105,14.3
1742,Tennessee,1985,41,1,0,0,0,1,33,4,6,0,0,10,99,11,132,8.3
1743,Texas,1985,39,0,1,0,0,1,31,10,5,0,0,15,150,16,181,8.8
1744,Utah,1985,44,0,1,0,0,1,29,2,4,0,0,6,75,7,104,6.7
1745,Vermont,1985,2,4,0,0,0,4,30,23,20,0,0,43,150,47,180,26.1
1746,Virginia,1985,42,0,0,0,0,0,40,9,2,0,0,11,100,11,140,7.9
1747,Washington,1985,5,4,3,0,0,7,49,16,12,0,0,28,98,35,147,23.8
1748,West Virginia,1985,17,2,1,0,0,3,34,16,4,0,0,20,100,23,134,17.2
1749,Wisconsin,1985,13,1,2,0,0,3,33,12,10,0,0,22,99,25,132,18.9
1750,Wyoming,1985,3,2,0,0,0,2,30,11,11,0,0,22,64,24,94,25.5
1751,Alabama,1984,46,1,1,0,0,2,35,7,0,0,0,7,105,9,140,6.4
1752,Alaska,1984,22,1,0,2,0,3,20,2,3,0,0,5,40,8,60,13.3
1753,Arizona,1984,8,2,3,0,0,5,30,5,9,0,0,14,60,19,90,21.1
1754,Arkansas,1984,47,1,0,0,0,1,35,4,2,0,0,6,100,7,135,5.2
1755,California,1984,29,2,0,0,0,2,40,6,6,0,0,12,80,14,120,11.7
1756,Colorado,1984,2,2,3,0,0,5,35,9,11,0,0,20,65,25,100,25
1757,Connecticut,1984,4,5,2,0,0,7,36,16,20,0,0,36,151,43,187,23
1758,Deleware,1984,14,2,1,0,0,3,21,3,4,0,0,7,41,10,62,16.1
1759,Florida,1984,13,7,2,0,0,9,40,11,8,0,0,19,120,28,160,17.5
1760,Georgia,1984,38,2,0,0,0,2,56,14,3,0,0,17,180,19,236,8.1
1761,Hawaii,1984,5,3,2,0,0,5,25,9,3,0,0,12,51,17,76,22.4
1762,Idaho,1984,16,4,1,0,0,5,35,3,8,0,0,11,70,16,105,15.2
1763,Illinois,1984,15,4,4,0,0,8,59,7,13,0,0,20,118,28,177,15.8
1764,Indiana,1984,28,2,2,0,0,4,50,6,8,0,0,14,100,18,150,12
1765,Iowa,1984,30,0,1,0,0,1,50,11,5,0,0,16,100,17,150,11.3
1766,Kansas,1984,18,2,1,0,0,3,40,10,10,0,0,20,125,23,165,13.9
1767,Kentucky,1984,42,2,0,0,0,2,38,7,1,0,0,8,100,10,138,7.2
1768,Louisiana,1984,49,0,0,0,0,0,39,5,0,0,0,5,105,5,144,3.5
1769,Maine,1984,6,4,2,0,0,6,33,21,14,0,0,35,151,41,184,22.3
1770,Maryland,1984,11,2,0,0,0,2,47,29,4,0,0,33,141,35,188,18.6
1771,Massachusetts,1984,24,5,1,0,0,6,40,13,6,1,0,20,160,26,200,13
1772,Michigan,1984,32,1,1,0,0,2,38,10,4,0,0,14,110,16,148,10.8
1773,Minnesota,1984,18,5,4,0,0,9,67,13,6,0,0,19,134,28,201,13.9
1774,Mississippi,1984,50,0,0,0,0,0,52,5,0,0,0,5,122,5,174,2.9
1775,Missouri,1984,25,2,0,0,0,2,34,16,7,0,0,23,163,25,197,12.7
1776,Montana,1984,26,2,1,0,0,3,50,12,4,0,0,16,100,19,150,12.7
1777,Nebraska*,1984,27,0,0,0,0,6,49,0,0,0,0,0,0,6,49,12.2
1778,Nevada,1984,34,1,1,0,0,2,21,2,2,0,0,4,42,6,63,9.5
1779,New Hampshire,1984,1,0,6,0,0,6,24,51,64,0,0,115,400,121,424,28.5
1780,New Jersey,1984,35,2,1,0,0,3,40,5,3,0,0,8,80,11,120,9.2
1781,New Mexico,1984,40,1,2,0,0,3,42,2,4,0,0,6,70,9,112,8
1782,New York,1984,31,4,1,0,0,5,61,16,2,0,0,18,150,23,211,10.9
1783,North Carolina,1984,20,5,0,0,0,5,50,15,3,0,0,18,120,23,170,13.5
1784,North Dakota,1984,33,2,2,0,0,4,53,6,7,0,0,13,106,17,159,10.7
1785,Ohio,1984,37,1,0,0,0,1,33,7,3,0,0,10,99,11,132,8.3
1786,Oklahoma,1984,38,1,0,0,0,1,48,7,4,0,0,11,101,12,149,8.1
1787,Oregon,1984,7,4,2,0,0,6,30,8,6,0,0,14,60,20,90,22.2
1788,Pennsylvania,1984,48,1,0,0,0,1,50,2,7,0,0,9,203,10,253,4
1789,Rhode Island,1984,17,1,8,0,0,9,50,10,3,0,0,13,100,22,150,14.7
1790,South Carolina,1984,44,2,1,0,0,3,46,9,0,0,0,9,124,12,170,7.1
1791,South Dakota,1984,22,1,2,0,0,3,35,2,9,0,0,11,70,14,105,13.3
1792,Tennessee,1984,45,1,0,0,0,1,33,3,5,0,0,8,99,9,132,6.8
1793,Texas,1984,43,0,0,0,0,0,31,9,4,0,0,13,150,13,181,7.2
1794,Utah,1984,36,0,1,0,0,1,29,3,5,0,0,8,75,9,104,8.7
1795,Vermont,1984,12,3,1,0,0,4,30,15,13,0,0,28,150,32,180,17.8
1796,Virginia,1984,41,0,0,0,0,0,40,9,2,0,0,11,100,11,140,7.9
1797,Washington,1984,10,5,3,0,0,8,49,13,7,0,0,20,98,28,147,19
1798,West Virginia,1984,21,3,0,0,0,3,34,14,1,0,0,15,100,18,134,13.4
1799,Wisconsin,1984,9,0,2,0,0,2,33,12,12,0,0,24,99,26,132,19.7
1800,Wyoming,1984,3,2,1,0,0,3,30,11,8,0,0,19,64,22,94,23.4
1801,Alabama,1983,47,0,1,0,0,1,35,5,0,0,0,5,105,6,140,4.3
1802,Alaska,1983,20,1,0,2,0,3,20,2,3,0,0,5,40,8,60,13.3
1803,Arizona,1983,8,2,3,0,0,5,30,5,9,0,0,14,60,19,90,21.1
1804,Arkansas,1983,46,1,0,0,0,1,35,4,2,0,0,6,100,7,135,5.2
1805,California,1983,30,2,0,0,0,2,40,6,6,0,0,12,80,14,120,11.7
1806,Colorado,1983,2,2,3,0,0,5,35,9,11,0,0,20,65,25,100,25
1807,Connecticut,1983,3,6,2,0,0,8,36,16,20,0,0,36,151,44,187,23.5
1808,Deleware,1983,14,2,1,0,0,3,21,3,4,0,0,7,41,10,62,16.1
1809,Florida,1983,13,7,2,0,0,9,40,11,8,0,0,19,120,28,160,17.5
1810,Georgia,1983,39,2,0,0,0,2,56,14,3,0,0,17,180,19,236,8.1
1811,Hawaii,1983,5,3,2,0,0,5,25,9,3,0,0,12,51,17,76,22.4
1812,Idaho,1983,16,4,0,0,0,4,35,3,9,0,0,12,70,16,105,15.2
1813,Illinois,1983,15,4,4,0,0,8,59,6,13,0,0,19,118,27,177,15.3
1814,Indiana,1983,28,2,2,0,0,4,50,6,8,0,0,14,100,18,150,12
1815,Iowa,1983,31,0,1,0,0,1,50,11,5,0,0,16,100,17,150,11.3
1816,Kansas,1983,17,2,1,0,0,3,40,10,11,0,0,21,125,24,165,14.5
1817,Kentucky,1983,42,2,0,0,0,2,38,7,1,0,0,8,100,10,138,7.2
1818,Louisiana,1983,49,0,0,0,0,0,39,3,0,0,0,3,105,3,144,2.1
1819,Maine,1983,6,4,2,0,0,6,33,21,14,0,0,35,151,41,184,22.3
1820,Maryland,1983,10,3,0,0,0,3,47,29,4,0,0,33,141,36,188,19.1
1821,Massachusetts,1983,22,5,1,0,0,6,40,13,6,1,0,20,160,26,200,13
1822,Michigan,1983,32,1,1,0,0,2,38,10,4,0,0,14,110,16,148,10.8
1823,Minnesota,1983,19,5,4,0,0,9,67,13,6,0,0,19,134,28,201,13.9
1824,Mississippi,1983,50,0,0,0,0,0,52,3,0,0,0,3,122,3,174,1.7
1825,Missouri,1983,23,2,0,0,0,2,34,16,7,0,0,23,163,25,197,12.7
1826,Montana,1983,25,2,1,0,0,3,50,12,4,0,0,16,100,19,150,12.7
1827,Nebraska*,1983,27,0,0,0,0,6,49,0,0,0,0,0,0,6,49,12.2
1828,Nevada,1983,34,1,1,0,0,2,21,2,2,0,0,4,42,6,63,9.5
1829,New Hampshire,1983,1,0,6,0,0,6,24,51,64,0,0,115,400,121,424,28.5
1830,New Jersey,1983,38,1,0,0,0,1,40,4,5,0,0,9,80,10,120,8.3
1831,New Mexico,1983,41,1,2,0,0,3,42,2,4,0,0,6,70,9,112,8
1832,New York,1983,33,4,1,0,0,5,61,15,2,0,0,17,150,22,211,10.4
1833,North Carolina,1983,18,5,0,0,0,5,50,16,3,0,0,19,120,24,170,14.1
1834,North Dakota,1983,29,2,2,0,0,4,53,7,8,0,0,15,106,19,159,11.9
1835,Ohio,1983,36,1,0,0,0,1,33,7,4,0,0,11,99,12,132,9.1
1836,Oklahoma,1983,39,1,0,0,0,1,48,7,4,0,0,11,101,12,149,8.1
1837,Oregon,1983,7,4,2,0,0,6,30,8,6,0,0,14,60,20,90,22.2
1838,Pennsylvania,1983,48,1,0,0,0,1,50,2,7,0,0,9,203,10,253,4
1839,Rhode Island,1983,26,4,1,0,0,5,50,10,4,0,0,14,100,19,150,12.7
1840,South Carolina,1983,44,2,1,0,0,3,46,9,0,0,0,9,124,12,170,7.1
1841,South Dakota,1983,20,1,2,0,0,3,35,2,9,0,0,11,70,14,105,13.3
1842,Tennessee,1983,45,1,0,0,0,1,33,3,5,0,0,8,99,9,132,6.8
1843,Texas,1983,43,0,0,0,0,0,31,9,4,0,0,13,150,13,181,7.2
1844,Utah,1983,37,0,1,0,0,1,29,3,5,0,0,8,75,9,104,8.7
1845,Vermont,1983,12,3,1,0,0,4,30,16,13,0,0,29,150,33,180,18.3
1846,Virginia,1983,35,1,1,0,0,2,40,10,1,0,0,11,100,13,140,9.3
1847,Washington,1983,11,5,3,0,0,8,49,13,7,0,0,20,98,28,147,19
1848,West Virginia,1983,24,3,0,0,0,3,34,13,1,0,0,14,100,17,134,12.7
1849,Wisconsin,1983,9,0,2,0,0,2,33,12,12,0,0,24,99,26,132,19.7
1850,Wyoming,1983,4,2,1,0,0,3,30,11,8,0,0,19,64,22,94,23.4
1851,Massachusetts,1982,1,5,0,0,0,5,40,7,7,1,0,15,160,20,200,10
1852,Alabama,1981,47,0,0,0,0,0,35,5,1,0,0,6,105,6,140,4.3
1853,Alaska,1981,28,1,0,1,0,2,20,3,1,0,0,4,40,6,60,10
1854,Arizona,1981,8,3,2,0,0,5,30,4,8,0,0,12,60,17,90,18.9
1855,Arkansas,1981,48,1,0,0,0,1,35,2,2,0,0,4,100,5,135,3.7
1856,California,1981,28,2,0,0,0,2,40,4,6,0,0,10,80,12,120,10
1857,Colorado,1981,4,2,2,0,0,4,35,9,10,0,0,19,65,23,100,23
1858,Connecticut,1981,3,6,2,0,0,8,36,14,22,0,0,36,151,44,187,23.5
1859,Deleware,1981,13,1,1,0,0,2,21,4,3,0,0,7,41,9,62,14.5
1860,Florida,1981,25,2,2,0,0,4,40,9,4,0,0,13,120,17,160,10.6
1861,Georgia,1981,39,2,0,0,0,2,56,12,3,0,0,15,180,17,236,7.2
1862,Hawaii,1981,10,1,3,0,0,4,25,6,4,0,0,10,51,14,76,18.4
1863,Idaho,1981,31,1,1,0,0,2,35,2,6,0,0,8,70,10,105,9.5
1864,Illinois,1981,14,2,2,0,0,4,59,10,18,0,0,28,177,32,236,13.6
1865,Indiana,1981,35,2,2,0,0,4,50,3,5,0,0,8,100,12,150,8
1866,Iowa,1981,17,0,2,0,0,2,50,6,10,0,0,16,100,18,150,12
1867,Kansas,1981,15,2,2,0,0,4,40,9,9,0,0,18,125,22,165,13.3
1868,Kentucky,1981,38,2,0,0,0,2,38,7,1,0,0,8,100,10,138,7.2
1869,Louisiana,1981,49,0,0,0,0,0,39,2,0,0,0,2,105,2,144,1.4
1870,Maine,1981,5,4,2,0,0,6,33,18,18,0,0,36,151,42,184,22.8
1871,Maryland,1981,12,3,0,0,0,3,47,21,4,0,0,25,141,28,188,14.9
1872,Massachusetts,1981,32,5,0,0,0,5,40,7,6,1,0,14,160,19,200,9.5
1873,Michigan,1981,24,0,0,0,0,0,38,10,6,0,0,16,110,16,148,10.8
1874,Minnesota,1981,19,3,2,0,0,5,67,13,6,0,0,19,134,24,201,11.9
1875,Mississippi,1981,50,0,0,0,0,0,52,2,0,0,0,2,122,2,174,1.1
1876,Missouri,1981,23,2,0,0,0,2,34,16,4,0,0,20,163,22,197,11.2
1877,Montana,1981,22,3,1,0,0,4,50,6,7,0,0,13,100,17,150,11.3
1878,Nebraska*,1981,27,0,0,0,0,5,49,0,0,0,0,0,0,5,49,10.2
1879,Nevada,1981,21,1,1,0,0,2,20,3,2,0,0,5,40,7,60,11.7
1880,New Hampshire,1981,1,0,3,0,0,3,24,52,69,0,0,121,400,124,424,29.2
1881,New Jersey,1981,40,1,0,0,0,1,40,3,4,0,0,7,80,8,120,6.7
1882,New Mexico,1981,44,0,2,0,0,2,42,2,3,0,0,5,70,7,112,6.3
1883,New York,1981,33,3,1,0,0,4,60,9,5,0,0,14,150,18,210,8.6
1884,North Carolina,1981,16,3,0,0,0,3,50,15,4,0,0,19,120,22,170,12.9
1885,North Dakota,1981,17,0,3,0,0,3,50,3,12,0,0,15,100,18,150,12
1886,Ohio,1981,37,1,0,0,0,1,33,3,6,0,0,9,99,10,132,7.6
1887,Oklahoma,1981,34,1,0,0,0,1,48,6,5,0,0,11,101,12,149,8.1
1888,Oregon,1981,6,1,0,0,0,1,30,12,7,0,0,19,60,20,90,22.2
1889,Pennsylvania,1981,45,1,0,0,0,1,50,2,9,0,0,11,203,12,253,4.7
1890,Rhode Island,1981,28,4,1,0,0,5,50,8,2,0,0,10,100,15,150,10
1891,South Carolina,1981,42,1,1,0,0,2,46,8,1,0,0,9,124,11,170,6.5
1892,South Dakota,1981,26,1,2,0,0,3,35,3,5,0,0,8,70,11,105,10.5
1893,Tennessee,1981,46,1,0,0,0,1,33,2,3,0,0,5,99,6,132,4.5
1894,Texas,1981,41,0,1,0,0,1,31,10,1,0,0,11,150,12,181,6.6
1895,Utah,1981,36,1,1,0,0,2,29,3,3,0,0,6,75,8,104,7.7
1896,Vermont,1981,7,3,1,0,0,4,30,20,15,0,0,35,150,39,180,21.7
1897,Virginia,1981,43,0,1,0,0,1,40,8,0,0,0,8,100,9,140,6.4
1898,Washington,1981,2,4,4,0,0,8,49,17,10,0,0,27,98,35,147,23.8
1899,West Virginia,1981,19,2,0,0,0,2,34,12,2,0,0,14,100,16,134,11.9
1900,Wisconsin,1981,11,0,2,0,0,2,33,11,7,0,0,18,99,20,132,15.2
1901,Wyoming,1981,9,2,1,0,0,3,30,6,8,0,0,14,62,17,92,18.5
